11111111111111111111111111111111111111111111111
10100000001000000000100010000010000000100000001
10101111101011111011101010111010111010111011101
10100010100010100010001010101000100010000010101
10111010111110101110111010101111101111111110101
10001010000000100000001010100000100000001000101
10101011111010111110111010111010111111101011101
10101000001010100010100010001010000000101000001
10101111101010101011101111101011101110101011111
10101000101010101010001000101000101000101000001
10101010101011101010101010101011101011101111101
10101010000010001010101010001010001010100010101
10111011111110111010101011111010111010111010101
10001000001000101000101010001010001000100010001
11101110111011101110111011101011101110101110111
10001000100010000000100010001010001010101000001
10101011101111101111101110111010111010101011111
10101010100000100000101000001010100000101010001
10101010111110111111101011101010101111101110101
10101000001000100010001010001010101000101000101
10111111101011101010111010111010101011101011101
10000000101000001010001010000010100010001000101
10101111101111111011101111101110111010111110101
10101000001010000010001000100010100010100000101
11101011111010111010111010101110101110101111101
10001000001010101010000010101000100010100010001
10101111101010101011111110101011111010111010101
10100000100010100000000010101010000010000010101
10111110111010111111111010111011101111111110101
10001000100010000000001010001000100000001000101
10101011101111111111101111101010111111101011101
10101010001000001010001000001010000010001010001
10101010111011101010101011111011111010111011101
10101010100000100010101010001010001010001000101
10101110101110111010101010101010101011111110111
10100010101000100010101010100010101000001000101
10111010101011111110111010111110111111101011101
10001000101010000010100010100000100000101000001
11101111111010111010101110111110101110101111111
10100000100010101000100010001000101010001000001
10111110101010101110111011101011101011101111101
10001000101010100000001010000010001000100000001
10111011101110111111111011111010111011111111101
10001000001000100000001000001010001010001000001
10101111101011101111101111101111101010101011111
10100000001000000000100000000000001000100000001
11111111111111111111111111111111111111111111111
