11111111111111111111111111111111111111111111111
10001010100010101010000000000000000010001010001
11101010101010101011101011101111111010101011101
10100000101000001000001000100010000010100000001
10101011111110111111111111111111101011101011111
10101010001000000010001000001010001000101010101
10111010101110111111101110111011111011101110101
10100010100010100000001000100000001000001000001
10101011111010111110111110111110101011101011111
10001000100000101000000010000000101000100010001
11101110111010101111111010111011101110101110101
10101000000010100000001000001010001000100000101
10101110111011111011101111101111111110101111101
10001000001000000010001010000010100000100000101
11111110101111111111101010101010111010111011101
10001000101010000000001010101000101010100010101
10101010111011101111111011111110101011111110111
10101010000000100000000000001000001010100010101
10101111101111101110111011101010101010111010101
10101010001010001000001000101010101000100000101
10101011111011111110111011111110111010101110101
10101010100010101000100000000010001010100010101
10111010101110101010111011101110101110111110101
10000010000010101010001010001010101000000000001
10111110111110101110101110111011101110101010101
10101000001000001010101000001010001000101010101
10101110111110111010111111101010111011111010111
10001010000000000000000010000000000010100010001
10111011111010101110101111101111101010111110111
10101010001010101000100000100010101000001000001
10101011101110111111101111101110111110111011111
10100010100010100000101000100000100010100000001
10101010101010101010111011111011111010111111101
10001010001010001010100010001000001000100000101
10111111101011101111111010111111111110111110111
10001000001000100000000010101000001010101000001
11101110101010101111111110101111101011101011101
10000010101010001000000000000000100010000010001
10111011101111111011111110111110101111101110111
10101010101010101010001010001010000000101010101
11101010101010101111101010111010111011101010101
10000000000000000000000000101000100000001000001
11111110111011111011111011101011111011101110101
10100000001000001000001000100010100000101000101
10101010111111111110101011101010101011101110101
10001010000000100000101010001000101010001000101
11111111111111111111111111111111111111111111111
