11111111111111111111111111111111111111111111111
10000010001000000000000000000000001010101000101
11101010101011111111101011101011101010101011101
10001010100010101000101000101010100000000010001
10101111111010101110111111101110111110111110111
10100000000010000000100010100010000010000000001
11111011101010101011111010111011111010111011111
10001010001010101010100000000010000010100010001
10101110101110111010101010111010111111101010111
10101000101000001000101010101000101000001000001
10101011111011111010101111101011101111111110111
10100000100010000010000010000000001000001000101
10101110111111101111101011101110111011111011101
10101010101000000010001010001010100010000010001
10111010101011101110111011111010101110111110101
10100000001010101010100000100010000010000000101
11111110101110101010111111111011101111101111101
10100000100000100010100000100000101000000010101
10101011111011111011111011101111101110101010101
10001010001000101000101010101010100010101000101
11111110101110101110101010101010101111111111101
10001000101010101010100010000000000010101000001
11101011111010101011101010111110111010101111101
10101000101000000010001000001010001010001000101
10101010101110111111111110111010101011101110101
10000010100010001000101010000010101010001000001
11101011101111101011101011111110111010101111111
10001010101000100010000010001000100000100010101
10111010101011101110111010101011111111111010101
10101000000010001000100010101000000010100010001
10101011101111111010111111101111101010111111101
10100010000010000010100010001000101000001010101
10101011111011111011101111101110101110111010101
10101000001000000000000000001000000010000000001
11111010111111111111111110111110111110111111101
10001010100000001010101000100010100000000000101
10111111101110111010101010111011101011111110111
10000010101000000000000010000000101000101010101
10111010101010111111101111111111101111101010101
10001000001010100000000000000010000010100000101
11111110111110111010111010111011111010111110101
10001000100000101010100010001010000000001000001
10101010101110101011111111101111101111111111101
10100010101000101000000010100000000000000010101
11101011111010101110101110101010111110101110101
10001000100010100000101000001010100000101000001
11111111111111111111111111111111111111111111111
