11111111111111111111111111111111111111111111111
10100000001000000000100010000000001000000000001
10101110101111101111111010111111101110111110111
10000010100000101000000010101000000010001000001
10111110111110101010111110101011111011111011101
10001000100000101010000010101000100010001010101
11101011101111101011111010101110101110101010101
10001000100000101010001000100010101000100010001
10111110111011101010101111111010101011111110111
10100010101000100010100000001000100010100010001
10101010101110111110111111101110111110101011101
10001010000010000010100000101010100010001000101
11111111111011101110101110101010101010111110101
10100000100010100010101000101000101010100000101
10101111101110111010111011101011101010101111101
10000000000010001010001000100010001000100000101
11111111111010101011101010111110111111111110101
10001000000010101010001010000010100010000000101
10111011111111101010111011101010101010111110111
10100010001000100000100010001010101000100010001
10101110101010111111101111111010101111101011101
10100000101010100010100000001000100010001000101
10111111101010101010111110111111111010111110101
10100010001010001010001000001000100010000010001
10101010111011111011101011101010111111111010111
10101000101000100010001000101010001000000010001
10101010101111101111101111101011101011111111101
10101010100000001000000000101010001010001000001
10101011111011111011111110101011111011101011101
10101000100000100010001010101010000010001000101
10101110111110101110101010101010111110101110111
10100010100010001000101010001000000010100000001
10111010101111111011101011111011111110111111101
10001010100000000010001000001010000010001010001
11101010111111101111111011101110111010101010111
10001010000010000000001010000000100010100010001
10111011111010111111101011111011111010111011101
10000000001010100010001000001000100010001010101
11111111101011101010101111101110101111111010101
10001010001000001000101000100010100010000000101
10101010111111111111101110111011111010111111101
10100010100010000000100000001000001000100000001
10111110101010101111101111101111101111101111111
10000010101010100000101000100010000010001000001
11101010101010111110111011101011111010111111101
10001000101000000010000000001000000010000000001
11111111111111111111111111111111111111111111111
