11111111111111111111111111111111111111111111111
10000000100010000010000000000000000000100010001
11111011111011111010101011111111101011101110111
10001010001000001000101010001000101010001010001
10101010101010111011111110111011111110111010101
10101000100010101000101000100000001000101010101
11101110111011101011101110101011111110101010111
10100010001010000010100000101000100000000010001
10111010111111101110101010101111111011101010111
10001000001000000000001010100000001000101000001
10101110101110111111111111101011111011111111111
10101010100010101010101000001010001000100000101
10111010111110101010101010111110111011101111101
10101000100000000000001010100000000010000000001
10101010111011101010101011101111111110101110101
10000010101000101010101010000000000000100010101
11101111101011111111111011101110101010101011111
10100000001000001010100010000010101010101000001
10101011111011111010101111101111111111111111101
10101010001010100000001010000010101000001000101
10111011101010111011111010111110101110111011111
10100010100000001010001000001000101010100000001
10101110111010111010111011101011101010111011111
10000010101010001000101000101000000000000000101
10101110101011111110101011111011111111111011101
10101010000000000000000000000000000010101000001
11101011111011111011111010101110111110101111101
10000000101010101010001010100010000000000000101
10111110101010101111101111111010101010111011111
10101000001000100010100010001010101010001000001
10101110101011101110101110111111101111111110101
10001000100000001010000010001000100000100010101
11111110111011101010111110111011101010101111101
10000000101000100000000000000000101010100010101
11101110101111101110111111111011111111101010111
10001010000010000010000000101000001010101000001
11111010101011101011111011101010111010101110101
10000000101010001000100000001010000000001000101
11111110111110111011101011101011101010111110111
10100010001000001010101000101000101010001010001
10101110111011101110111110101010111011111010111
10100000101000100000101010101010100000001000001
10111110101011101111101011111011101110101110101
10000000001010000000000000001000100010101000101
11101110111011101110101110101011111110101110101
10000010100010001000101000101000001000100010101
11111111111111111111111111111111111111111111111
