11111111111111111111111111111111111111111111111
10000000000000000010000000100010000010001000001
10111111111111101010101011101111101110111011111
10100000100010001010101000100000100010001000001
10101111111010101111101011111110101111101011111
10100000001000100000001000001010000000000010101
11101110101011101110111010111010101011111110101
10001010101010101000001010100010101000100000001
11111011101010111111111110111011101011101111111
10101000000000101010100000000010101010000000001
10101111111110101010111111111010101010101011101
10000000101010000000100000100010101000101000101
10111111101011101111101111101110111011101110101
10000000000000101000000010100010100010000010101
11111011101111101111101110111110101011111011111
10000000100010001010001010001000001000101000001
11101011101010101011101010101011111111101111101
10001010101000101000000000101010100010100000101
10101010111011111011111010111010101110111011101
10101000101010001010000010101010001010000000101
11111011101110111011101010101010111010101110101
10001000000010101010101010000010100000101000001
11101010111110101110111110101110101111111110101
10001010000000000010000010101000101000000010101
10111010111111101010111111101110111011101011101
10101010100010001000001000100000100010001000101
10101011111011101011111110111011101111101010101
10000000100010101010001000001000101010001010001
10101111101110111010111010111110101010111011101
10100010100000100000001010100000101000100010001
10111110101010111110111010101111111111111110101
10100000001010001010100010000000000000001010101
10101010101011101010101111111111101111111011111
10001010101000101010000000100010100000001000001
10111111111111101011101011101110111011101110111
10000000100010100000101010100010001010000010001
11101010101110101011101010101110101111111010111
10001010000010101010001010000000100000000000001
10111110101110111111101110101011111110101110101
10101010101000001000101000101000100010100010101
10101011111110101110101011101111101110111110111
10000010000000100000001000101000100010001010001
11101111111111101011111110101011101110101010111
10101000000000101000100000101010000000100010101
10101010111110111011101010111010111110111010101
10000010000010001000101010000010000010100010001
11111111111111111111111111111111111111111111111
