11111111111111111111111111111111111111111111111
10100000001000100000001000101000001000000010001
10101110101110101110101010101011101011111011101
10001000101000001000100010001010001000001000101
10111011101011111011111111101011111111101110101
10001010101010000000100010100010001000001010001
11101010101011101111101010111110101110101010111
10101010001000100010001000000000100000101000101
10101011101110111010101111111111101111101111101
10001000100010100010101000000010101000100000001
11111110111110101110101110111010101011111111101
10001000100000101000100010100010001000000000101
10101011101110101011101010101111111011111110101
10101000101000101000101000100010000010000000101
10111010101011111110111110111010111110111110101
10100010001010001010001000100010001000001000101
10101111111010101011101011111111101111101011111
10001000001000101000101000000000100010101000001
11111011101111101110101111111110111010101011101
10001010000000000000101000000010000010001010001
10101010111111111111101011111011111111111010111
10100010000000001000001000100010001000101010101
10111111111111101011111110101010101010101010101
10001000001000001010001000101010101010001010101
11101011101111111010101011101010101011101010101
10100010001000001000100010001010100010001010101
10111011111011101111111110111010111110111110101
10001000001000100000100000100010001000100000001
10111111101110111110101111101110101011101011111
10000000001000001000100010101000101010101010001
11111010111011101011111010101111101010101010101
10001010100010001010000010101000001010001010101
10101010101110111011111110101011111010111011101
10100010100010100010001010001000001010001000001
10111110111110101110101011111011111011111011111
10000010000000100010101000000010001010001010001
11111011111110111010101110111010101010101010101
10100010000010001000101000001000101000100010101
10101110111011111111101011111111111011111010101
10001010001010000000101010000010000010000010101
10111011101010111111101110111010111110111110101
10100000001010000000101000101000001000000000101
10101111111010111110101011101111101111111111101
10001010001010100010001000101000100000101000101
11111010101010101010111110101010111110101010101
10000000100010001010000000100010000000100010001
11111111111111111111111111111111111111111111111
