11111111111111111111111111111111111111111111111
10000000101000000010000010000000000000001000001
10111110101011101110101011111111111011101011101
10000010001010101000101010000000001000100000101
10111011111010101011101010111111101110111111101
10001010000010100010001000100000101000100010001
11101010111110111110111111101111101011101110101
10001010001000001000100000100000001000001000101
10111011101110111011101110111110111111101011101
10101010000000100010001010000010001000001000101
10101010111111101110111011111011101111101110101
10101000100000001000100010000010100000101000101
10101111101111101011101010111110111110101011111
10100000100010001010001010001000000000101010001
10101110111010111010111011101110111110101010101
10001000001010001010101000100010001010101000101
11111011111010111010101011111011111010101111101
10001000100010100010100010000010001010101000101
10101110101110101110111110111110101010101010101
10101000101000101000100010000000100010101010101
10101011101011101011101011111111111110101110101
10100010001000101000001000100000001000100010101
10111110111011101011111110101011101011111010101
10000010100010001000100010101010001010000000101
11111010111110111110111010101011101010111111101
10000010000010100010000010101000101010100010001
10111111111010101011101110101110111010101010101
10100010000010101000101000101010000010101010101
10101110101110101111101011101011111110101010101
10001000101000101000001010001000001000001010101
11111010111011101011111010111011101111111110101
10001010100010000010001000000010100000000000101
10101010101111101110111111111110111111111111101
10100010100000100000100000100000000000000000101
10111111111110111110101110111111101111111110101
10100000100010001000101010001000100000001000101
10101110101011101011101011101010101111101011101
10100010001000101000101000100010100000101000101
10111011111011101011101011111110111110101111101
10100010001000101010001010000000101000100000001
10101110111110101110111010111111101011111111111
10101000100000100010101000100000001000100000101
10101011101111111010101011101111101110101110101
10001000100000001000101010100010100010101000101
10111110111111101111101010111010111010101011101
10000000000000100000000010000000001000001000001
11111111111111111111111111111111111111111111111
