11111111111111111111111111111111111111111111111
10000000101000100010100000101000100010001000101
10101010101011101110111110101011101111101011101
10101010001000100010100000100000100010000000101
11101111111011101110111011111110101110111010101
10000010101000000000100000000010100010001010101
10101010101110101110101110101010101111101011101
10101000001000100010100010101000100010001000001
11101111111011101110101110101111101011111111101
10101000101000100010000010100000001010001000101
10101011101110111111111111111111111110101110101
10001010001000001000001000100000100010100000001
11101010101010111110101110101110101111111011111
10001000100010000000101000101000100010001000101
10101110111011101010101110111011101110111011101
10100000001010001010101010100010101010101000001
11101111111011111111111010101110101010101110101
10000000001000001000001000100000100010000000101
11101111111011111110111110101110101110111111111
10100000001000001000001000000010100000000000101
10101011101011101110111110111111111011101110101
10001010001010001000001010101000101010000010001
10111111101011111011111010101011101010101010111
10000010001010001000001000001000100010101010001
10111010111011101010111010101110101111111111101
10100010001000000010001010100000001010000000001
11111011111011111111111010101111101011111111101
10000000001000000000000010100000100010001010101
11111011111111111111111111111111101110111010101
10000010001000001000100000000000101010000000101
11101111101010101010101010101110101011101110101
10101010001010100010001010100010000010001000001
10101010111110111111111111111111111111111111111
10100010001000001000100000100000000000101000001
10101110111011111110111110111011111111101011101
10000000001000001000100000100000101000101010001
11101111101011101011111110111010101110101011101
10000010001010001000100010000010100000101010001
11111011111010101011101110101110111011101011101
10000000001010100000100000100010100000100010001
11111110111110111110111110111011111010101010111
10100000101000001000000000100000000010101010001
10101011101110111011111111111110111110101010101
10001000001000001000101010100000100010001010101
10111011111011111010101010111110111010101011101
10001000001000001010000000100000100000101010001
11111111111111111111111111111111111111111111111
