11111111111111111111111111111111111111111111111
10100010000000101000100010000010001000101000001
10101111111011101110111011101110101011101110111
10000000001000100000001000000010101000001000001
11111011111110111110101011111010111111101010111
10000000100000000010101010100000101000001010001
11111011111110111010111110111011101110111110111
10100010000000101000100000100000000000001000001
10111010111010101111101110101110111011101011101
10001000100010101010001000001000001010100010001
10101011111011101010101110111011111010111011101
10100010000000000000101010001010001000100010001
10111111101111101011111010111011101010111011101
10101010001000001000100010001000001010100000101
11101010111111101110101011101110111110101110111
10100010001000101010001000100010100000100010001
10111010111110111011101110101111111011101011101
10100000001000001010101000100010001010001000101
10101110111110111010111111111111101110111110111
10001000000000100010001000000000100010100010001
10101110111110101011101111111110101110111011101
10101010001000101000000010000010000000100000001
10101010101011111010101010101111111011111111101
10101000101000100010101000100010101010100010101
11111110111010111110111011101010101010111010101
10000000100010000010100010001010001000101010001
10111010101011101111111010101010111010101011111
10001010101000100010000010101010100010001000101
10101110111011111010111111111010101111101010101
10101000100000001010100010101000101000000010001
10111011111110101110101110101110111111101111111
10101010001000100000001000000010100010101000001
11101111101110111011111010111111111010101011111
10000000000000001010001010001000001000000010001
10111011101111101110111011101110101010101111101
10100010001010101010001010000000101010101000001
10111011111010111010111111101111101011111110101
10001010100000001000000010100000100010001000101
11101110101110111010111010111110111011101110101
10100000100010101010001010100000001000000000101
10111011101010101011111110101010111011101011101
10100010101010000010000000101010101000101000101
10101110101111101111111011101110101110101111101
10000010000010000000000000101010100010100000101
10111010101111101011101010111010101110111110101
10001000100010001010001010100000000010100000101
11111111111111111111111111111111111111111111111
