11111111111111111111111111111111111111111111111
10100000000010001000000010001000001010000010001
10101111111010101011111010101011101010101011101
10100000100010101010001000101000101000101000101
10111110101110101110101011101110101111101110101
10000000101010100000101000100010100000001000101
10111111101010111111101010111010111110111011101
10101000000000100000001010100010000010001000001
10101011111111101111111110101111111011111111111
10100000100000000010100000100000001010000010001
10111110111111111110101111111111101010101011101
10001010100010000000100000100010001010101000001
11101010101010111111111110101010111010101111111
10100010001000100000000010001010000000100010001
10101110101111101111111010111111111111111010101
10101000100010001010001000100010000000000010101
10101011111011101010101111101011101111111110101
10101010000010001000101010001010001010000010101
10101110111110101110101010111010111010111010101
10001000100010100010101000101010100010001010101
11111011101010111110101110101010111011101010111
10000010001010100000100010001010000000101010001
10111110111010101111111011101011111110101011101
10000000100010001000001000101000001000101000001
11111111101111101111101110101111101011101111111
10001000100000001000001000100000101000100000101
10111010111111111011111011101110101010111110101
10000010100000101000100000101000101010100000101
10111110111010101110101111101011101110101111101
10001000000010001010001010001000101000101000101
11101111111111101011111010111010101011101010101
10100010000000101000001010001010100000001010001
10111011101110101011101011101011111111111011101
10001000101000100000101000001000000010000010001
11101110111011111111101111111111111010111110111
10000010100010001000100000100000000010001000001
10111010101010101110111110101111111111101111101
10100010001010100000100010101000000000100000101
11101011111010101111101011101011111010101111101
10001010100010100000001010000010001010101000001
10111010101110111111111010111110101110101011111
10100000100010100000100000100010100000001000001
10111111111010111010101111101011111111111111101
10100000000010001010101000101000000000000000001
10101111111011101110101010101111111111101111111
10000000001000000000100010100000000000100000001
11111111111111111111111111111111111111111111111
