11111111111111111111111111111111111111111111111
10101010100010000000000000101000100000000000001
10101010111011111111111011101110101110111110101
10100010000000000000000000000010101010101000101
10101111101111111011101111111010111011101011111
10100010001010000010001000000000000000000000001
10101011111011101011101111101010101011111011111
10001000000000001010001010001010101010000000001
10111111101011101111101010111111101111111110111
10001000001010001010001000001000001000100000001
11111010111110101011111010111111111011111110111
10100010001010100010000010100000000000000000101
10111111111011101111101111111110111010111110101
10000000001000000010001000000000001010100010001
10111010101010111110111111111110111111111010101
10100010100010100010001010100000100010000000101
11111111101011111010111010101011101111111011101
10100010101000101010100000101010100000000010001
10111010101111101010111010111110101010111011101
10001000000010000000001010000000001010100000101
10111010111111101110101110101110101011101011101
10000010101000000010101000101000101010001010001
10111011101111111111111110111110101010101011101
10001010100010000000000010001000101010101010001
10111110101011111111111011111111101111101110111
10001000001010100000000000000000000010001010001
10111111111010111111101111101010111010111010111
10101000000000000000101010001010100010100000101
11101110101011111010101011101110111110111011101
10100000101000100010000010001000000010001000001
10111011101110101110101111101010101010111110111
10000010100010101000100010001010101010001010001
11101110101111101010101110101110101110101010111
10001000000010101010100010101000101010100010001
10111111101110111010101111111110111011101010111
10100000001000000010100000101000100000101010001
11111010101111111110111110101110101110101111101
10100010100000101000001000100000101010001000101
10101111101110101010101011101011111010111011101
10001000000010001010101000101000100000001000001
10101011101111111110111110101011101111101110111
10101010100000001000100010101010000010000010001
11101110101110111110101011101111101010101110111
10000010001010001000101000000010001010101000001
11101111101011111110111011111110101011111011101
10001000000000100000100000100000101000100010001
11111111111111111111111111111111111111111111111
