11111111111111111111111111111111111111111111111
10000000101000100010101010000000001000000000001
10101010101110101110101011101011111111101111111
10101010001000001000001010001010101010100010101
11111111101111101011101011111010101010101110101
10100000000010100000101010000010001010000000101
10111111101110111011111011111010111011101111101
10000010101000101000101000001000101000000000001
10101110101010101011101011111011101111101111101
10100010001010000000100000100000100010101010101
11101111101110111011111011111110101110101010111
10101000100010100010000000001000100010000010001
10101110101011101011111011111110101110111110111
10000010001000101010001010100000000000000010001
11101111111110111011101010111111101011111110111
10100000100000000000000000100010001010000000001
10101110111111101011101010101111101111111010111
10000010100000001010101010001000100010100010101
10101111111111111110111110101010101110101111101
10101000101000101010100010101010000010001010001
10101110101011101010111011101111101110111011101
10100000100010001010001000001000001000000010001
11111110111011101010111011111111101110111111101
10000010001010100000001000100000000000100010101
11111011101010111111101110101111101111111010101
10000000101000000010000000101000001000100000101
11101111101111101111111110111111101110111110101
10000000000000101000001000001010001000101010001
10111011111011101110111110111011101110101010111
10100010000000000010000000100000000000000000001
11111011111110101010111110111110111111101111101
10000000100000101010101010000000101000101000101
11111111101011111011101011101110101110101011111
10100010101010100000000000000010100000000000001
10101110111110101111101010101111111110101111111
10100010000000001000001010101000100000100000101
10111010111011111111101111111110101111111011101
10000000101010101010000000101000001000001000101
10101110101110101010101011101110111111101011101
10101000100000000000101010001000100000000000001
10111110101011101010111010101111101111101011101
10100010101010001010100010101010101010101000101
10101110111111101110101111101010111010111011101
10100000001000001000101000000000100000000000101
10101111111011101010111111101110101010101011111
10100010000010001010001000000010001010101000001
11111111111111111111111111111111111111111111111
