11111111111111111111111111111111111111111111111
10000000000000100010000000001010001000000010101
10111110111010111010111011111010101110101010101
10100010001010100000001010100010101000101000101
10111010101010101011101010101010111110111010101
10101000101010001010001000001010101000100010101
10101010111011111111111011111110101111101111101
10100010001010101000100010100010000000101000101
10111111111110101011101010111010111011101110101
10001010100010000000001000000010001000000000101
10101010101011101111111111111111101010101111101
10100000001010000000100000000010001010100000101
10111111101010111110111010111011101111111111101
10101000101010000010000010001010000000000000101
10101110101011101111111110111111111011111111101
10101000101010000010001000100010101010001000101
10101011101011111010111010101010101010101010101
10100000001010000010001010001010000010101010101
11111011111110111011101011111111101010101011101
10000010101010100010000000000000001010100000101
10111010101011111011101011111010111111101111101
10100010000010000010001000100010101000000000101
10101111111010101110111010101010101010111111101
10100000001010100010001010101010000010001010101
10101111101011111111111011111110111110101010101
10100010000010000000000000000010000010100000001
11111111111111111111111111111111111110111111111
10100000001000000000100000101000000000001000101
10111010111010101110101010101010111010101010101
10100010001010100010001010101010100010100010001
10101111111111111111101111101111111111111011111
10000010001000001000000010101000000010101000001
10101010101111101011101110101010111010101111101
10101000100000001010000000101010100010100000001
10111110111110101010101110101010101110101111101
10101000001000101010100010001010100000101010001
10101111101110111010111110101110111111101010101
10100000001000100010000010101000100000001000101
10101011101110101011111111101011111110111110111
10101000101000001010001000101000100000100000101
10111110111011111011101011101110101010101110101
10100000001000001000100000101000001010100010001
10101111111011101010101110101010101111101111111
10100000101000101010001000100010100000100010101
10101110101010101010111011101111111011101010101
10100010001010101010001000101000000000101000001
11111111111111111111111111111111111111111111111
