11111111111111111111111111111111111111111111111
10000000000010000010100010001000000000000010001
10111111111010111010101011101011111110111110101
10001000100010001010001000001000100000100010101
11101010101111101011101111101110101111101010101
10001010101000001000100000100000101000001000101
10111011101010111110111110111111101011111111101
10100000001010100010000010100010001000001000001
10111111111010101111111010101010111110111011111
10100000100010100000001000101010100000100010001
10101010101110111110101111101010101111101110101
10101010001010101000100000101000100000100000101
10101011111010101011111110101111111110111111101
10001000100010100010000010101000100010001000101
11111110101110101111101110101010101011101010101
10000000100000101000101000100010001010001010101
11111110111110101010101011101111101010111010111
10000010100000101010000010001000001000001010001
10101110101111101011111010101111111111101011101
10100000100010001010000010101000100010101000101
10111111111010111110111110101010101010101111101
10000010001010001000100010100010001010000000101
11111010101011101011101010111111111011111110101
10000010101010001000001010000010001010000000101
11101110101010111111101111111011101010111111101
10001000101010000010100000001000101010001000101
10111011111011111010101111101110101011101010101
10100000001000001010101000100000001000101010001
10101111101111111010101010111111111110111011101
10101000100000001000100010000000001000100000101
10101010111111101111111111111111101011101111101
10100010100010001000100000000000101000101010001
10111110101110111010101111111011101110101010111
10100000100010001010001000101000001010000010001
10101111111011101011111110101111101010111110101
10100000100000100010000000001000001010100010101
10111110101111111110101111111011111010111010101
10001000100000001000100000001000001010001000101
11111011111011101011111011101111101011101111101
10000010000010101010100010101000100000101000001
10111110111010101010101110101011111111101011111
10100010101000101000101000100010000000101010001
10101010101111101110101110111110111110101011101
10001010001000001000100010000010100010001000101
11111011111011111111111010111110101011111111101
10000000000000000000000010000000001000000000001
11111111111111111111111111111111111111111111111
