11111111111111111111111111111111111111111111111
10100000000000000000001000000010001000001010001
10101111111111111111111011111010111011101010101
10001000000000000000001000101000100010001000101
10111011111111111111101010101010101110111011101
10001000000010000000001010001010000010100010001
11101111111011111010111111111011111110101110111
10001000100010001010100000001000100010101000101
10111010111010101110101111111110101010111011101
10100010001010100010000000000010001010000000101
10101111101011101011111111101011111011111111101
10101000001000001000100010001010000010000000101
10101011111111111010101110111110111110111110101
10001000100000100010100010000010100010101000001
10101110101111101111111011101010101110101010111
10101000101000100010001000001000100000101010101
11101011101010111010111011111110111111101010101
10001010100010101010001010000010001000001010001
10111010111010101011101010111111101010111011111
10001000001010001000001000100000100010100010001
10101111111010111111111011101110101111101010101
10100000100010001010001000101010101000001010101
10111110101111101010111010101010101110111110101
10100010001000101010000010101000100010000000101
10101011111010101011111110101111111011111111101
10001000001010101010001010100000000010000000101
11111111101110101010101010111111111110111110101
10001000100010100000100010000010000000100010001
10111011111010101111111111111010111011101011111
10000000100010100000001000000000101000001000001
10111010101110111111101011111110101111111110101
10100010101000000000101000100010101000000000101
11101110101111111110101111101011101011111111101
10001010000000100000100000001010001010001010001
10111011111110101111111110111010111010101010111
10100000100010101000001000100000100010101010101
10101110101010101011101011111111101111101010101
10100010001000101010101000100000100000100010001
11111011101111101010101110101011101010111011101
10001010001000001010000010001000001010000010101
10111011111011101011111011111111111011111110101
10001000100010101010001000001000001000100000001
11101010111010101010111111101011101010101111111
10100010001010001010000010001010100010100010001
10111111101011111011101010111010111111111010101
10000000000010000000001010000010000000000000101
11111111111111111111111111111111111111111111111
