11111111111111111111111111111111111111111111111
10000000000000000000000000000000000000000000001
10111011101011111111101011111011101110111011101
10001000101010000000001000001000101000001010001
11101010101111101110101010101111101110101010101
10001010100010000010101010100010001000101010101
10101010111011101011101110101110101111101011111
10101010001010001010000010100010100000101000001
10101011101111111011111111101010101010111011111
10101010000000001000100000001010101010100000001
10101110101110111011111011101010111111101111111
10101000100010100000001010001010000000100000001
10111111101111101010111011111110101010101111101
10100000000000101010001000000010101010100010001
10101111101010111110111110111111111010111010101
10101000001010000010001000000000001010001010101
10111111101110111011111011111111111010111011101
10001000001000100000001000000000001010001000101
10111111101011101011101010111110101011101010101
10000000101010001010001010100000101010001010101
10111010101010111010101110111111101111101111101
10001010101010100010101000000000101000001000001
10111011111111111111111010111011111111111110101
10100000000000001000000010001010000000000000101
10111011101110101011101011111110111111111111101
10100000101000101000101000001000001000000000001
11101111111010111110101110101011101010111110111
10000000100010000010100010101010001010000010001
10111110111011111111101010101011101011101011101
10000010100000000000101010101010001010001010001
10101010101011111111101011111010101010111110101
10101010101010000000001000100010101010100000101
10111011111010111110101110111011111010111011101
10001000001010100000101000001000001010001000101
11101111111111101010101010111111111111101110101
10000010000000001010101010000000000010000010101
10111011101110111111111011111010101011101011101
10100010001000000000001010000010101000101000101
10101010101011101011111110111110111010101111101
10101010101010001000100000000010001010101000001
10101111101011101011111011111010111011101110111
10101000001000101010000000001010100010001000001
11101011111011111110111011111110101110111111101
10001000100010000000100010000000101000001000001
10111110101011101011101010111110111010111010111
10100000101000101000101010001000001010100010001
11111111111111111111111111111111111111111111111
