11111111111111111111111111111111111111111111111
10001000001000100010000000000000100010001000001
10101110111010101010111111101111101011101011101
10100010000010101010001000001000101000001010001
11111010111110101111101011111010111011111010111
10000010001000100000001000001010100010000010001
10111011101011111111111110111010101110111110101
10100010101000000000000010000010000000100000101
10101010101111111111111111111010111111101111101
10101000100000100000000000100010001000001000101
10111110111110111111101110111111101011111010101
10000010100010100000101000000010001000000010101
11111110111010101110101111111010111111111110101
10000000100010001000001000001010001000100010101
10111011101111101011111011101011101010101010101
10001000100010001000001000101000001010101000101
11101110111010111111101110101111111010111111111
10000010100010100000100000100010000010100010001
11111110101010101110111111111010111011101011101
10001000001010100010001010000010101000001000101
10101011111011111011101010111110101111111110101
10101000101010000010000010000010001000100010101
10101010101010111111111111101011101010101010101
10101010101010000010000000001000100010101000101
10101110101010111010111111101110111111101011101
10101000101010001000100000100010001000001010001
10101010101011111111101110101111101011111010111
10101010101010000010000010101000001010001010001
11101011101010101010111010111011101010111011101
10000000101000101000101010000010100000100010101
10111110101111111110101011111110111111101110101
10100010100010001000100010000010000000100000101
10101011101010101111111111101011111110111011101
10001000101000100000100000101000000010100010001
11111110101111101011101110101110111010101110111
10000010001000101000000010001010001000100010101
10111111111110111011111011111011101110111010101
10100000100000100010001010001000001000100010101
10101010101111101110101010101111111011111110101
10101010101000000010100010100000001000000000101
10101010101011111110111110111111101111111111101
10001010100010000010001000100010001000100000101
11111011101111101011101111101010101010101010101
10001000101000001000100000101010100010101010101
10111110101011111110111110111010111110111010101
10000000000010000000000010000000100000000010001
11111111111111111111111111111111111111111111111
