11111111111111111111111111111111111111111111111
10000000000010000000000000001010000000100000001
10101111111010111111101111101010111010101111101
10101000100010100000001000101000100010001010001
11101010101110101111111010101111101111111010111
10101010001010100000100010000000001000001000101
10101011111010111110101111111111111011111011101
10101010000010000010101000000000100010000010001
10101010111111111010111011111110101010111110111
10101010000000000010000000100000101010100000001
10101011101111111111111111101111101110111111101
10001000100000001010000000001000000000000000001
11111110111111101010111111111011111111111111101
10000010101000001010000000100010000000100010001
10111010101011111011111110111110111110101011111
10101010100010000000100000100000101000101000001
10101010101110101111101011101111101011101111101
10100010101000101000001010000000001000000000101
10101110101110101011111010111111111111111111101
10100010100010101010001010100010000010000000001
10111110111011101010101110101010111010111111111
10000000100010001000100000101000100000100000001
10111111101110101111111111101111101111101111101
10001000101000100000100000100000101000100000101
11101011101010111110111110111110111010111110101
10101000000010100010001000000010100010000010101
10101011111110101011101011111010101111111010101
10001010001000101000100010000010101000100010101
10111010101111101110111111101110101110101110101
10100010100000101000000000100010000000100000101
10111110111110101111111110101111111110111111101
10001000100000100010000010101000100000100000101
11101011101111111011111010111010101111101110101
10100010001000000010000010000010101000100010101
10111110111011111110111011111110101110111010101
10000010001000100000001000000010100000001010001
11111011101010111111101111111010111011111011111
10000000101010100000101000001010001010001000001
10111110101110101110101011101011101110101111101
10100010100010101000001000101000100000100000101
10101010111010101111111010111011111111111110101
10101010001010100010000010000010000000000010101
10101010111010101010111111111110111110111010101
10001010100010101010100010001000100010001010001
10111011101110101011101010101011101011101111101
10001000000000101000001000100000001000100000001
11111111111111111111111111111111111111111111111
