11111111111111111111111111111111111111111111111
10000000000000000000000000000000000000000000001
10101011111110111111101010101111101011101110101
10101010000000000010001010101000001000101000101
10101110111110111010111010101111101011111010111
10101000001000100010100010100000101010000010001
10101011111010111011111111111011101111101111101
10101010000010001000001000000010001000001000001
10111010101110111111101111101010101010101011101
10001010100010100000000000101010101010101000101
10101011101011101110111011111011111110101011101
10101000101000100010100000001000001000101000101
10101110111011101111101010101010111110101010101
10100010001010000010001010101010100000101010101
10101110111110101111101011111111111011111110111
10101000100000101000001010000000000010000000001
10101111101011101011101010101110111010101010111
10100010001000101000101010101000100010101010001
10111010111111111110111111111110111110101011101
10100010000000100000001000000000000010101000101
11101010111111111111111010111110111011111011101
10001010000000000000001010000010001010000000101
10101111101011111011101110111011111011101010101
10100010001000100000100010001000001010001010101
11101110101010111011101010101011111110101010111
10000010101010100000101010101000001000101010001
10111110101110101111111110101011101111101111101
10100000101000101000000000101000100000100000101
11101111111011111011111110101110101110111010101
10000000001000100010000000101000100010001010101
10101111111110101111101111101010111110111011111
10100010000000100000100000101010001000100000001
10111111101110101110111111111111111111101111111
10100000000010101000100000000000000000000000001
10101110101010101110101010101111101111101010111
10101000101010100010101010100010000010001010001
11101111101010111110111010111110111111111110111
10000000101010100000001010100000000010000000001
11111111101011111111111010111010101011111010101
10000000001000000000100010001010101010000010101
11101010101110101011101110101010111010101111101
10001010100010101000100010101010001010100010001
10101111101110111011111010101111101010111010101
10100010001000100000100010100000101010100010101
10101011101010111110111010111111111010111010101
10101010001010001000100010001000000010100010101
11111111111111111111111111111111111111111111111
