11111111111111111111111111111111111111111111111
10100000100010101000100010000010001010100000001
10111011101010101011111011111011101010101010101
10001000001010001000100010001000000000101010101
10101011101110101110101110111111101111111111101
10100000101010101010101000000010001000000010001
10111111111011101010101011101011101011101111101
10000010001000000010101010001000100010100010001
10101110111110111010101010101110101010101010111
10100000001000001010001010100010001010001000001
10101011101010111011101111111110111111111111111
10101000101010101000001000000000000010101000001
10111111101011101110111011111111111010101011111
10100000000000001000001010100010100000101000101
10111110111110101111111010111010111111101010101
10100000000010101000000000000000001010000010101
10101111111111101011111111101111111011111010101
10101000100010101000100010100000101000000010101
11101011111010101111111010111010101110111011101
10100000100000001000001000101010000000101000001
10101011101010101011111010101010101011101110101
10001000101010100000000010001010101010000000101
10111111101110101110101111111110111111111011111
10001000000010100010100000000000101010001010001
10111110101110111111101110111111101010101110111
10000010101000101010101000000000100000101000101
11111110111111101010111110111110111011111011101
10000000000000001000100010101000000010100000001
10111110101010111011101111101110101110101010101
10100010101010100000000010001010100000001010101
11111010101110111110101110101010111111111011111
10100010101000000000101000101000001000100000101
10111011101110111111111011111110101011101111101
10101000101000000000101000100010101000101000001
10101110101111101011101110101011101011111011111
10100000001000001000000000001010000000100010001
10101010101111101110111010111010101010101110111
10001010100000100010100010100010101010000000101
10111010111011111110101111111011101011101111101
10001010100000100010101000100000101000100000101
11111011101110101111101011101011111111111110101
10000000101000001000001000001000000000100000101
10111111111011111110101111111111111010111010101
10001000000000100000101000000000000010001010001
10111010111011101010111111111110111110111011111
10100010001010001010000000100000001000001000001
11111111111111111111111111111111111111111111111
