11111111111111111111111111111111111111111111111
10001000100000000000000010000010000000001000001
10111010101111111010111110111010111011111011101
10000010001000000010100000101000101000100010001
11111111111010111111101111101111101110101110101
10001000000010100010001000000000000010000010101
10101010111111101010111011111010111110111110101
10100010100000001010001010001010100010001000101
10111110101111111011101110101010101011111011101
10100000101000001000100000101010101010000010101
10111111101011111011111111101011101010111110101
10000000001000001010001000000010001000100000001
10111111111111101010101011111110111111111011111
10100000001000001000101000001000100010001000001
10111110101011111110101111101011101010101111111
10000000100010000010100010001010001000101000001
11111111111010111010111010111010111111101011101
10001000000010001010001000100010001000100010001
10101111111111101011101111101110111010111010101
10100000000000101000101000100010100010001010101
10111111111110101110111010111010101111101010111
10000010001010100010000010001000101010001010001
11111010101010111011111111111110101010111011101
10001010101010000010100010000010101000100000101
11101010101011111110101010101011101011111110101
10001000100000000010101010101000001000001000101
10111111111111111010101010101011111111101011101
10000000100000100010001010101010001000101010001
10111010101111101111101010101110101010101010111
10100010001000001000101000100000101010001010001
10101111101011111010101111111111101011111110101
10100000101000000010100010000000001010000010101
10111110111111111110111010111111111011101011101
10001010100000100010001010100010001000001000001
11101010101110101011101010101011101111111111101
10101010001010001000101010101000100000001000001
10101011111011111011101010101110101111101011111
10001000001000001000001010000010100010001000101
10111110101110111111111110111110111110111110101
10100000100010000000000010100000100000100010001
10111011111010111011111011101111101110101011101
10000010001010100010001010001000001000101000001
11111110111011101111101010111011111111101111111
10000010001000101000001000101000100000001000001
10111110101110101010111111101010101111111011101
10000000100000001010000000000010000000000010001
11111111111111111111111111111111111111111111111
