11111111111111111111111111111111111111111111111
10100000101000100010001010000010000010001000001
10101111101011111011101011101110101111101011111
10001000100000000000000000100000100000001010001
10101011111011101111111011111111111110111011101
10101010001010101000000000101000000000100000001
10101011101010111011111110101011101110111010111
10100000101000001010001000001000100010100010101
10101111101110101111101010111110111111111110101
10100000000000100000001010001000100000000000001
11111011111110111011111111101011111011101111101
10101000100000101000000000100010000000101000101
10101111101110101111111110111010111110101011101
10000000000010101010001010100000000010101000001
11111110111110101010111010111011111110111010111
10001010001010000010000010001000100010001010101
11101011101010111011111011111111101110111110101
10001000101000101010001010101000101000100010001
10101011101110101111101010101110101011111010111
10100000101000001010000000001000000000000010101
11101111111110111011101010111110111011111111101
10001000101010000000101010000000001010101010001
11101110101011101111101110111010111110101010111
10000010100000100010001000101010100010000000101
11101110101110111011111111101111101111101110101
10001000001000001000001000001000001000001000101
10111111111011111111101110111011111011111111101
10000000001000100010101010000000100010001000001
11111011111110101110101011101010101110101010111
10000000001000000000100000001010000000100010101
10111111111110101111101110111011101110111011101
10100010001010101000101000001010001000001000001
10101111101010101110111011101011111010111011101
10000000000000101000100010001010001010100000101
10101110101110111011101111111010111010111011101
10101000101010001010000010101010100010001000101
11111011111010111010111110101010111111111011111
10001010000010001000100000001000000000100000001
11101011101110101011111110111011101110111010101
10001010100000101000101000000000101000100010101
10111110111110111010101110111011101111101011101
10001000100000100010001000100010001010001000101
10111010101010101010111111101111101010111011111
10000010001010001010001000001000001000100000001
10111110101111111011111011111011111110101111101
10001000101000000010000000001000001000100010001
11111111111111111111111111111111111111111111111
