11111111111111111111111111111111111111111111111
10000000000000000000000000000000000000000000001
10111110101110101011111011101010111111101111111
10100000100010101000001000101010100000000000001
10111011111110111010101010111111101010111110101
10001000001000001010101010000010001010000010101
11111010111111101111111110111011111111101011101
10000010000010000000000010001010000000001010001
11101111101111111010111011111111111010111010101
10001000001000000010001000000010000010100010101
10101111101011101010101111101011111111111111101
10100000101010001010101000001000000000000010001
11111111111110111110101111101111101010111110101
10000000000000001000100000101000001010100000101
11101011101010111010111111111110101110111110101
10001010001010100010000010000000101000000010101
10101110111111111111101111101011111111111111101
10100010001000000000001000001010000000000000001
11111010111010101111111111101011101011101111111
10000010100010100000001000001010001010000000001
10111010101011101110111110111010101011111110101
10001010101010000010100000100010101010000000101
10101110111110101010111110111110101110101010111
10101000000010101010100000000010100010101010001
10111110111010111111101110101110111110111011111
10001000001010100000000010100010100000100000001
10101011111010111110101111111010101111101011101
10101000001010001000100000001010100010001000101
11101010101111101010101111111011111011111010111
10001010100000101010100000001010000000100010001
11101111101111101010101010101011101010101010101
10000000100000101010101010101000101010101010101
10101010101111111011111011111111101111101011101
10101010101000000000100000001000000010001000101
11111011111011111111111110111110111110111011101
10000000100000000000000010001000000010001000101
11101010101011111110111011111011101110101110101
10001010101000000010001010000010000010100010101
11111010101011101010111111101010101111111110101
10000010101000101010000010001010101000000000101
10111011101111111011101011111111101010111010111
10100000100000100010001000000000101010100010001
10111111101010111011111110111011101111111110111
10000010001010001000001000100010000000000010001
11101110111011101011101011111011101011111111101
10001000001000101010001010000000101000000000101
11111111111111111111111111111111111111111111111
