11111111111111111111111111111111111111111111111
10101010101000100000000010100010100010100000001
10101010101110111111111010111010101010101011101
10100010001000001000100000001010101000001000101
10111010111110101011111110111010111111101111111
10001010100010100010001010101000000010000000101
11101010101111111010111010101011101111101011101
10101000001010100000100000000010101000001000101
10101110111010101110111010111110101111101111101
10000010100010101000001010100010000010101000001
11111010111010111010111111111011111010101011111
10000000101010001010001010000000001010100000101
10111110101010111110101011101010111010101111101
10100000000000101010101010001010100000000010101
10111011111110101010111011101110111011101110101
10100000100000101000101000101010101010001010101
11111111101110101010101011111010101111101010101
10000010001000101010001000000010000010001000101
10111111111010101111101111111010111111101110101
10100010001010000000000010000000000010100000001
10101110111110101111111011101111101110111010111
10000000000010100010001000000010001000100010001
11111110111111101111101011111110101110111010111
10001000001000000010100000100000101000000010101
11101010111011111110101011111110101111111011101
10100010100010000000001000100010100010001000101
10111011111011101011111011111011101111101011101
10001010001000101010101000001010001000000000001
11101010111110111110101111111010101110111010111
10100000100010101010101010100010101000100010101
10101010111011101010101010111011101110101011101
10001010001000000010101000101010001000101010101
11111111101110111010101011101011101110111010101
10100000101000100000000010100010101010100010101
10111011101111111010111010101110101011111010101
10001000000010001010100010000000101010101010001
10111110101111101111111010101010101010101011101
10000000100000001000100000101010000000000000001
10111111101110101110111111111111101110101110111
10100000001000100000100010100000101000101010001
10101011101111101110111010111110111111111010111
10101010000000101000000000000000000010000000001
10101111101011101111111010101010101011111110111
10100010001010101010001010101010101010100000001
10101011101110111011101110111110111010101011101
10101010000010000000000000001000001000001010001
11111111111111111111111111111111111111111111111
