11111111111111111111111111111111111111111111111
10000010000000100000000000000000000000000000101
11111010111111101111111110111111111111111110101
10000010001000001000000010000010000000100000101
10111011101010111011101011101011101110101111101
10101000100010100010001010001000101000100010001
10101110101111101110111010111110101111111010101
10001010101000001010100010000010100000000010101
10101010101011111010101111101110111111111110101
10101000101000001010101000101000000000001000101
11101111111111101010111010111011111111101011101
10001000001000101010000010100010000000101010101
10111011101010101010101110101010111110101010101
10000010001010001010101000101010001000101010101
11111011111011111011101011101011111010101010101
10000010001010001000001010101000100010101010101
10111010101010111111101010101111101011101010101
10101000101000001000001000101000101000100010001
10101111101111101011111110101010111110111110111
10000010100010001010001000101010000010000010101
11111010111010111110101011101010101111111010101
10001010001000100010101000100010100000001000101
10101011101110111010101110111111111110101111101
10100010000010001010100000100000000010100000101
10111111111011101010111110101110111010111110101
10100000100000101010101000100010001010101000101
10101110101110101010101010111011101110101011101
10101000101000101000100010000010100010001000101
10101110101011101111111011111010111011101011101
10101000101000101000001000001010000010001010001
10101011101110101110101111101111111110111010101
10001000001000100000101000000010000010001010101
11111111111110111011101111111110111110101010101
10000000000010100000101000001010000010101010101
10101111111010111111101010101011111011101010101
10100000001010000000100010101000001000101000101
10111111101011111110111111101111101110101111111
10001000001000000010001000100010000010100000001
11101011111111111011101010111010111010111110101
10101010000000100010100010001010101010000010101
10101011111011101010101110111010101011101011101
10001010000010001000100010100010001010001000001
11111010111110111111111011101111101010111111111
10000010000000100000001000100000101000100000001
10111111111111101011101110101111101011111111101
10000000000000001000100000100000001000000000001
11111111111111111111111111111111111111111111111
