11111111111111111111111111111111111111111111111
10100000101000100000000010000000000010000010001
10101110101010101111111010111111111010101011101
10100010001010100010000010100000001010101000001
10111011111010111010101110101111101010101111101
10001000100010100010101000101000101000100010001
10111110101111101110101011111010101111111011101
10100010101000101010101010000010100000001000101
10101010101010101010111010111110101110111110101
10101000100010000010100010100010101000100010101
10101111111111111010101110111010101011101010111
10001000000000100010100000100010001000101010001
10111110111110111110111111101111111110101011101
10100000100000100010000000000000001000101000001
10111011111110101011111111111011101011101111101
10001000000010001010000000000010001010100010101
11101011111011111010111111111110111010111010101
10101000100010000000100010000000001010001010001
10101110101111111111101110111111111010101010111
10101000101000000000100000000010001000101010101
10101011101011111110111111111110101111101010101
10101010001000000010001000001000100010001010001
10101110111111111011101011101011111010111011101
10101000100000001000100010100010001000100010001
10101011101110111110111110111110101111101110111
10101000000010000000100000000010100000001010001
10101111111111101111101011111110111111111011101
10101000000000100010001010000010100010000000001
10101011111110111010101110111010101010111110111
10100010001010100000101000100010101000100010101
10111110101010111011111011101110101111101010101
10000000100010001010000010100000101000101010101
11101111111011101110111110111110111010101010101
10001000001000100010100000000010100010001010001
10111011101110111010111110111010101111111011101
10100010101000100010100010001000100010100010001
10101110101011101110101010111111111010101111101
10001000101000101000001010100000001000100000101
10111110101111101011111010101111101110111110101
10100000100000001010100010101000100000100000101
10101110111111111010101111101010111111101111111
10001010000010000000100000001010000000100000001
11111011111011111110111111111011111110101111101
10000010000010001000000000001000101000100000101
10111010111110101111111111111110101011111111101
10001000000000100000000000000000100000000000001
11111111111111111111111111111111111111111111111
