11111111111111111111111111111111111111111111111
10000000000000000000000000000000000000000000001
10111111111110101110101011111110111011111111101
10000000000010100010101010000000100000000010001
10111011101111111010101111101110111111101011101
10001000100000001010101000001000000010001010001
10111010111111101110111010111110111011101010111
10100010000000101000001010100000100000101010001
10101111111010101010111111101111111011111110101
10100000001010101010100000001000000000000010101
10101110101010101110111111101010111011111010101
10100010101010100010001000001010100000001010101
10101110101111101110101011101110111011101110101
10101000100010000010101010000010100000100010101
11101111111110101111111011111010101010101011101
10000000100000101000000000100010101010101000101
10101111101010111010111110111111111111111110101
10101000001010001010001000001000000000000000101
10111110101111111111101010101110101011111010101
10000010100010000000001010100010101000100010101
11111011101011111011101111111011101111111110111
10000000101010000010000000001010000000100000001
10101111101111111110101010111110111011101111111
10101000000000100000101010000010001010000000001
11111010101010111110101110111111101010101111101
10000010101010100000100010100000001010100000101
10111010111110111111101010101011101011101011101
10100010000010000000101010101010001000101010001
11111010101011111110111011101110111010101110101
10000010101010000000001010001000001010100010101
11101111111110111011111110101011101111111011101
10000000000010100010000000101010000000100000101
10101010101111101111101011111110101011111011111
10101010100000101000001010000000101010000000001
10101111101111111011101110101010101111101111101
10100010000010000000101000101010101000000010001
11111110111010101010101011101011111010101011101
10000000100010101010101000101000001010101000101
11111110111011101111101010101111111011101010101
10000000001000100000101010101000000010001010101
11101011111011111011101111101111101111111111101
10001010000000001010000000101000000000000000101
11101011111011111011101010111111101010111010101
10001010000000001010001010000010001010001010101
10111111111110101111111111101111101010111111101
10100000000000100000001000000000101010100000001
11111111111111111111111111111111111111111111111
