11111111111111111111111111111111111111111111111
10100000001000100000000000000010000000100000001
10101111111010101111111011111010111111101111101
10100000000010001000001000001010001000001000001
10101111101111111011111111101111101010111011111
10100000100000001000001000100000000010001000001
10111110101111111111101010111111111111111110101
10100010100000100000101010000010000010000010101
10101010101110101110101011111010111010101011101
10001010100010100010101010100010100000101000101
11111010111010111010101010101110111111101110101
10001010001010101010100010001000001000101010001
11101011111010101010111111101011101011101011111
10001000001010101010000010001000101000101000001
10111111101010101011111010101110101110101110111
10001000101010001010001000101000101000101000001
10101010101011111010111011111011101011101011101
10101010101000000010100010000010000010001010001
11101010101111111110101110111111111110101011111
10001010001000100000100010100000100000100010001
10111011111010101011111010101110111111111010101
10001000100010101000001010101010100010001000101
10101110101011101111101010101010101010101111101
10100000101000100010101010100010001000101000101
10111111101110111010101011111110111111101010101
10000000100010100010001010000000100010001010101
11111011111010101111111010111111101011101010101
10100010001010000000100000100000001000100010101
10101110101011111110101111101111111110111110101
10100000100010001000101000100000000010001000101
10111111111110101010111010101111101111101011101
10000000000000100010000010100010001000101010001
11101110111111111110111111111010111010101110111
10001000100000000010000000001010100010100000001
11111011111111111011111111101011101110111111101
10001010001000001000100000000010000010000000001
10101010101010111110101111111110111111111111111
10101010101010100010101010000000100000000000001
10101010111010101010101010111111101111111111101
10100000100010101000001000100010001000001000001
10111111101110101111111111101010111011101010111
10100010001010000000100000101010101010001010001
10111010111010111111101110101010101010111011111
10000010001000001000001010001010100010001000001
11111011101111111011111011101011111011101111101
10000000100000000010000000001000000000100000001
11111111111111111111111111111111111111111111111
