11111111111111111111111111111111111111111111111
10000000000000000010000010000000000010000010001
11111111101111111010111011101111111010111011101
10000000101010000000100000001000000010001000001
10111110101010111111111111111011111110101111101
10001000001010001000100010001000000010101000101
10101011111010111010101010101111111011101011101
10101010001000100010001000100000001000001010001
10101110101111101111111111111011101111111010111
10101000100010000010000000001010001000100010001
11101011111010111110111111101010101010101111101
10001010001000100000101000001010101010100010001
10111010111111101111101011111010101010111010111
10001000100000101000100010000010101010001000101
10101110101110101010101110111110101011101011101
10100010101000001010101010001000101010001000101
10111010101111111011101011101011111010111110101
10001000100010000010001000001010001010001000001
10111111111010101110111111101010101011101111111
10100000000010100000000000101000101010100000001
11101110111111111111111110111011101010111111101
10100010100000001000000010001010001000000010001
10111011101111101011111011101110111110111110101
10001000101000100000001000100010000000100010101
11101110101110111111101110111010111111101010101
10100010101000100010101000101010100010001000101
10111010101011101010101011101010101110111111101
10000010001000101010001010000010001000100000001
10111110111110101011101011111011111011101111111
10001000100010101000101000001000000010101000001
11101110101010101110111111101111111110101011101
10100010001000101000100000001000000010001010001
10111011111111101011101111111111101010111011111
10001000001000101000001000000000001010100010001
10101111101010101111111011111111111110101110101
10100000100010100010000000000000000000101000101
11111110111110111010111111111111111111101011101
10000010000010001010000000000010000000100010101
10111011101011101011111111111011101110101110101
10001000001000100010000000001000001000100000101
10101111101111111110111011111111111011111111101
10100000101000000000100010000010001000001000001
10111110101011111110101110101010101111101011101
10001010101010000010101000101010100000101010101
11101010111011101010111011101110111011101010101
10000010000000001010000000100000001000000010001
11111111111111111111111111111111111111111111111
