11111111111111111111111111111111111111111111111
10000000001000000000100000000010000010000000001
10111011111110111010111110111111101111111010101
10100000001010101010100010100000100000100010101
11101011101011101010111010101110101111101010101
10001010000010001010100000000010001010101010101
10111011111010101010111011101111101010101010101
10100010100010100010100010000010001010001010101
10111110101110111110101110111110111011101111101
10100000000010101010101000001000101010101010101
11111111111010101010101111111110101010101010111
10001000100010001000000000101000100000000010001
10101110111011111011111110101010101011111110111
10100000000010000000101010101010101010100010101
11111011111110101110101010101110101110101110101
10101000100010100010101000100000000000000000001
10101110101111111011101111111110111110111111101
10000000001000000000100000100000001010000010101
10101111101110101111101110101111111011101110111
10100010001000100010101000001000000010000000001
10111110111010111110101111111010101110111011111
10100000001010001000100010000010100000100000001
10111011101110111011111111111011111011111111111
10001000100000000010100010000010001010101010001
10101111111110101110101110111010111010101011101
10100000100010101000000000001000001000000010101
11111011101011111110111110111110111110101110101
10101000001010001010001010000010001000100010001
10101111101011101011111011111111101011101110111
10000000001000000000101000000000101010100010001
10111110111010111010101010111010111010101110101
10001000100010100010101010100010101000101000101
11111010111010101111101110111111101110101110111
10000010100010101010001010000010100010100010001
11101111101011101011101010111110101011101111101
10000010001010000000001000000010001010000000001
11111111101011111010111011111110111010101111101
10100010001000100010100010000000001010100010001
10111011111111111010101010101111111110111011111
10000010101010000010101000100000101000001010001
11101010101010111111111011111010101110111110111
10001010001010100000001010000010100010101000001
10101110101010111011101110101010111010101110111
10101010100010000000101000101010100000000000001
10101010111010101111101111101110101011111010101
10100000100000100010000000000010101000100010101
11111111111111111111111111111111111111111111111
