11111111111111111111111111111111111111111111111
10101000001000001010101000101000100000000000001
10101010101010111010101011101010101010111111101
10001010100010001000000000000010101010100000001
10111011111110111111101110111011111010101110101
10001000101000100000101000100000100010100010101
10101011101010101011101011111110101110101110101
10101000001010001000101000100000100010100010101
11101111101111101110101110111111111010101111111
10000000001000001000001000000000000010100000001
10111111111111111111111111111110111111111111111
10001010000010100000101000001010001010000010001
11101010101010111010101011101010111010101011101
10001000101000100010000010000000000000101000001
11101110111111111111111111101111111111111111111
10001000101000101010000000101000001010001010001
11101010101110101010101110101110101010101011101
10001010001000101000100010101000100000101000001
10111011101110101010101111101011111011111111101
10001010000000101010100010100000101010001000001
10111010111011101010101010101010101010111110101
10001010001000101010101000001010101010001000101
10111111111011101111111110101011101011101110111
10001000100010100000000000101000100000001000001
11101011111010111111111110111111111111111010101
10001000000000100010000000001010000010101010101
10111111111110101010101011101010101110101111101
10001000000000101010101010001000100000001010001
11101110111111111011111110111110111111101010101
10001010000000100010000000001010000000101000101
11101010111110101110111111111010101011101110111
10001010100000100010000000000000101000100010001
10111010111110111011101011101010111110101010111
10001000101010100010001000101010100000101000001
11101010101010101111111011111010111111101010101
10001010100000100010100000101010000000101010101
10111110111111111010111010101111111111101110111
10001000000010001010000010001000100000101000001
11101010111010101010101110111110101010101011101
10001010100000100000100010001000101010001000101
10101111101110111011101111111011101111111110111
10101000100010100010001000001000100000101010001
10111110111010101110101010101110101011101010101
10001000000010100010101010101000101000001010101
10101110101010101110111010101011101110101011101
10101000101010100010000010101000001000101000001
11111111111111111111111111111111111111111111111
