11111111111111111111111111111111111111111111111
10000000100000100000001000100000000010000000101
10111010111010111110111010101110111010111110101
10001010100010000010000010000010100010001010001
10111010101111111011111111111110101111101011101
10100010001000001000000000001000100010001000001
11101111111011101111111111101011111010111011111
10001000100000100000000010001010001000101010001
10111010111010111011111010111010111111101010101
10001010001010001010001010001010000000001010101
10101011101011101110101111101010111111101010101
10100010001010001000101000000010100010101010101
10111110111110111011101011111110101010101011101
10100000100000100010100000100010001000100010001
10101111101111101110111111101011111110111110111
10101000100000100000100010001000100000100000001
11101010111110111011101010111110101111111111101
10001010000010000010001000100010100000100000001
10111011111011111110111111111010111110101111101
10001010001000000000100000100010000010001000001
11101010101111111111111010101011111011111011111
10001010101000000000000010001010100010001010001
10101010101011111111101111111010101110111010101
10101010101010000000001000001000101000100010101
10111010101110111111111011101011101011101111101
10100010100000100010000010001010001000100000001
10101110111111101110111110111010111010111111101
10101000100000001000100010000010101010000000001
10101110111011111011101111101110101011111111111
10100010001010001010001000101000101000101000001
10111011101010101010101010111011101110101011101
10001000101000100010101010000010001000100010001
10111110101011111111101011101110101011111110101
10000000101000100000101010001010100010000000101
11111111101110111010101011111010111110101111101
10000000001010000010001000100010101000101000101
10111111111011101111111110101110101011101010101
10100010000000001000000010001000100000101010101
10101011111111111011111011111011111011101011101
10101000001000001010000010001010001010001010001
10101111101011101010111010101010101110111010111
10101000100010100010001010100010100010100010101
10101011111110111111101110111110111010101010101
10001000001000100000101000100000101010101010101
10111110101010111010101011101111101010101110101
10000000100010000010100000001000000000100000001
11111111111111111111111111111111111111111111111
