11111111111111111111111111111111111111111111111
10101010100010100000000010000000101010000010001
10101010111010111110101111101110101010111111101
10101010001000001000101000101010101000001010101
10101010111011101110111110101011101011111010101
10001000000000100010101000101000100000000000001
10101011111111111010101010101011101011101111111
10100010000010101010100010000000001000100000001
11111010101110101110101010111010101110111111111
10000000101010100010001010101010101010101000101
10111111111010101110111111101111101010101011101
10000000001010100000000000100010001010101010001
10111110111010101111101111101111111011101011101
10101010000000101000101000001000100000000000001
10101010101110101011111011111110111010111111101
10101000101000000000000000001000000010001000001
10101111111111111111111111111111111011101111111
10000000100000001010000000000010000000101000001
10101011111110111011101111111110101011111110111
10101010001000001010100010001000101000001010101
10101110101011111010101110111011111110111010101
10100000100000000000000000100000101010001010101
10111011111111111111111111111011101010111010101
10101000000000001000101000000010000010100010101
11101011101110111011101011111011101111111010101
10000000101000000000000000101010000010000000001
10101011101110101011111110101110111111101111101
10101000101000101000001010000000000000001010101
11101011101110111010111010111110111011101010111
10001010100010101010000010000010100000100000001
11101110111011101110111110101011111010101111101
10000000001000000010000010101000100010100000101
10101110111011101011101111111110111011111010101
10100010100000101010000010101010100010101010101
11101110101110111111111110101011111010101111101
10000010101010001010101000000010100000000010001
10111011101010111010101111101010111011101111101
10001010001000000000000000001000100000100000101
10111111101110111010101010101111111111101110111
10000010000010100010101010101000000000101010001
10101111101011111110101011101011111111101010111
10101010001010100010101000100000100000101010101
10111010101010101110111010111011101111101011101
10001000101010001010100010001000000000101000001
10111011111010111011111010111011111111101011111
10100000100000000000100010001000000010000000001
11111111111111111111111111111111111111111111111
