11111111111111111111111111111111111111111111111
10000000000000000000000000000000000000000000001
11111111111111111111111111111111101111111111111
10101000001010000000000000001000100000001000001
10101111101010101010111011111011111110111011101
10101010001010101010001000001010100000001010001
10101011101011111010111011101010101010101010101
10101000000000100010001010001000101010100010101
10101011111010101011101010101011111011101011111
10001010101010001010001010101000000000101000001
10101010101111101111111111101111111111101111111
10100000001000000010001000101000001000100000001
10101011111110111110111110101010101010111110101
10101000001000000010000010001010100010100010101
10101111111111111010111010101111101111111010101
10101000100000100010001000101000001000100000101
10101110111010101111111110111110101010111011101
10101000000010000010000000001000100010100000101
11111011111111111111111111111111111110101111111
10100000001000100010001010101000001010100000001
10111010111110111010101010101111101010101111101
10101010101000000010100000000000001010001010101
10101010101011111011111011111110101010101010101
10100010000000100010000000001000100000101000001
10101110111111101111111110111111111111111111101
10100010100000100010100000001010100000101000001
10111010101010101110101111101010101010101011101
10100010001010100010000010001000001010000010001
10101111111111111010111110111111111111111111101
10100000001000101000100010001010000000000000001
10101011111010101010101010111011111111111110111
10001000001010100010001010001000000000000000001
10101010101010101111111111101011111011111111111
10101010100010100010000000001010000000001000001
10111111111111101111101111111011111110111011111
10100000000000000010000000001010100000000000001
11101111111111111111111110111010101110111011111
10000000000010101010001010001010101000001000001
10101010101010101010101010111010101011101010111
10101010101000000010100010001010101000101010001
11111110101111111111101011101010111011111110111
10101000101000100010001000001010001010101000101
10101011101010101011111110111010101010101110101
10000000100010101010001010001010100000001000001
11111110111011111010101010101011111011111011111
10000000100000000010100000101010000000001000001
11111111111111111111111111111111111111111111111
