11111111111111111111111111111111111111111111111
10000000000010000010000000100010000000100000001
10111011111011101110101110101010111110101111101
10101000001000100000101010101010100010001000101
10101111101110111011101010101010111011111110101
10000000101010001000101010001010001000000000101
11111110101011101111101011111011101011111010101
10001000101000100010001000100010001010000010101
10101111101010111010111110101110111010111111101
10100000001010000010100000101000100010000010001
10111111111011111110101011101011111111101010111
10000010000010100000101000000010001000101010101
10111010111110101110111111111110101110101010101
10001010001000001000100000001000100010101000101
10111011101011111011101111101011101110101111101
10100010101010001010001000101010100000100000001
10101110101110101010111011101010111111111111101
10100010000010100010001000100010000000000010001
10111011111010111011101110111110111011111011111
10101000001000101010100000100010101010001000001
10101111101111101010111110101010101010101111101
10100000101000100000001000101010101000100010101
10101110101010101111111011101010101111111010101
10001010101010001000001000101000000000001010001
11111010101111111011101110111111111111111010111
10000010100000000010001010000010000000000010001
11111010111111111110101011111010111111111111101
10001010100010000010101000001000100000001000001
10101010101010111110101111101111101110111011111
10101000001000100010100000000010000010001010001
10101111111111101010111111111011111111101010101
10101000001000001000100000001000001000001000101
10101011101011111111101111111111101010111111101
10101010101010000000100000100010000010100000001
10101010101010111111101110101010111111101111111
10100010100010100000100010001010001000001000001
10111110111110101110111011111011101011111011101
10100010001000000010001010001010001000100010101
10101110101011111110101010111010111110101110101
10100000100000100010100000100010001000100010001
10111110111111101011111110101110111011101011101
10100010000010001000001000100000100010001000101
10101011111110111111101111111111101110111110111
10001000100000100000100000000000001000000010001
10111110101111101110111111111111111111111111101
10000010000000001000000000000000000000000000001
11111111111111111111111111111111111111111111111
