11111111111111111111111111111111111111111111111
10101000001010001000100010101000001000101000001
10101011101011101011111010101111101011101110101
10001000100010100010101010001010100000100000101
11101111101110111010101010111010101010101111111
10001010100000001010100000100010101010000010001
11101010111010111010111010101110101111111110111
10101010100010000000000010000000000000101000001
10101010111010101010111010101011101111101011101
10100010100010101010101010101000101000000010101
10111010111111111011101110111010101011101110111
10000000001010000010100000100010100000100000101
11101011101011111110111010111011111111111110101
10001010000000000010000010100000100010001000001
11111011101111101011101011101010101110111111101
10000010101000001000001010001010000010000010001
10111010101111111111101110101110101110111110101
10001000101010000010001000101000100000001010101
11111111111011101111101110101111101011101011101
10101000100010000000001000101010001010000000101
10101011111011101110111011101010101011101111101
10000000101010001000001000101000101010000010001
10101110101010101011101011101010111110101111101
10101000000000101000101000101010000010100000101
11111010111110111010111110111010111110101110111
10000010101010101010000010001010001000101000001
11101010101011101011111111101011111110101111111
10001010100000000000000010101000100000100000001
10101011111010111011111110101011101110101110101
10101000100010001000000000101010001000101000101
10111111101110111011101010101110101110111111101
10000010001000100000101010101000101000000000101
10111111101011111011111011101110111110111011111
10101000001000100000100010001000101010001000001
10101011101110101110101011101010101010101011111
10100010001000100010101000101010000010101000101
10111011101010111111101010111110111011111110101
10101010001010000010101010000010100000000010101
10101011111110111010111010101011111110111011101
10100000100000001010000010101010001000100000001
11101111111110111111101011101110111010111111101
10001000101000000000101010001010000010000010001
11111110101011111011101011101010111010101110111
10000000000000001010101010000010001010101000001
10111011111011101110111111111010111011101110111
10100000100000100000000000001010100010000010001
11111111111111111111111111111111111111111111111
