11111111111111111111111111111111111111111111111
10000010101010100010000010000000001010000010001
10111010101010101110111010101010111010111110111
10001010000000100010001000101010101010000010001
10101010101111101110111111111010101011111010111
10101000100000101010100000100010000000001000001
11111111111110101010111110111011111110111011101
10000010100000000010100000101010001010000010001
11101010111010101110101110101010111011101110101
10001010000010100000100010101010000010100010101
11101011111010101110111011101010111110111010111
10001000000010100010000000100000000010000010001
11111010111110111011101111101010111111111010111
10000010000010100010000000101010000010000010001
11111111111111111111111111111111111111111011111
10101010001000000000001000101000000000001000001
10101011101110111111111011101111111011111011111
10100000101010001000101000101000101010101000001
10101110101010101110101010101010101010101010101
10100010001010100000001010001010001010100010101
10101011101011111110101111101011111010101011101
10101010001010101010100000001000001000001010001
10111010101010101010101110101110111010101110111
10100010101000000000101000101000000010101000101
10111010111011111111101011101110111111111010101
10101010001000000000101000101010100000101010001
10101010111111101111111111101010111110101110111
10100010101000000010001000001000000000101000001
10101110101010111010111010111010101010101011101
10100010000010001000001010001010101010001010001
10101111111111111110111111111010111110101110111
10100010001000000010001000001010100000101000001
10111011101111111011101010101111111111101110111
10001010001000100010000010101000000000001000001
10101010111110111010111110111111111011111011111
10100010001000000000001000001000000010001010001
10111010111011101111101011111111101111101010101
10100010000000100010001000001010101010001000101
10111010111111101111101111101010101011101110111
10100010001000000010001000001000001010001010001
10101111111111111111111110111111101010111010101
10100010000000001000101000001010000010001000101
10101110111010101010101011101011101010111111101
10100010101010100010100010001000001000001000001
10111010101110101011101110111111101110101110111
10100010001000101000000010000000000010101000001
11111111111111111111111111111111111111111111111
