11111111111111111111111111111111111111111111111
10100010001010001010000010001010101010000010101
10111011101011101010111111101010101011111010101
10001010000010000000001000000000001000000010101
10101011101111111011111010101111111111111010101
10101010100000001000100010100010101000000000101
11101010111011111011111011101110101111101111101
10001000101000001000000010101000101010101000101
10101110101110111011111110111110101010101011101
10101000000000000000001000001000100010000010101
11101110101010111011111110111011111010101010101
10000010101010101000001010101010000010101010001
11101111111111101010111010101010111111101110111
10001010000010001010001010100000100010001000001
11101011111010111110111010111011101111101111101
10100010101000101000001000100010001010000000001
10101110101110101010111010111010111010111111111
10001010101010101010100010001010100000001010001
11101010101010101011111011111010111011111011101
10101000000000000000100000001010101000100010001
10101111101111101111111011111010101011101110111
10100000101000100010100010000000100000100000101
10101110111110101110111010111111101110101111101
10000010100010000010001010101010000010101010101
10111111111010101111101010101010111110101010101
10101000100000100000100010100000101000100000101
10101011111111101111101110101111101111101111101
10001010101010101010000000001010101010100000101
10111010101010101011111011101010101010111011101
10101000100010100010000010001010001010001000001
10101110111010101111111011111011101011101011111
10000010000010000000100000001000100010001010001
10111111111011111011111011101011101111101011101
10001010101010101000101000101000101010000000001
11101010101010101011101011111011101011101011111
10001010100000101010101010000010000010001000101
11101010101111101010101010101111101110111010101
10000010101010000010000010101010001000001010001
11111010101010111111101110111011101110111111111
10100010001000101010000010001010100000101010001
10111011101011101011101110101010111011101010111
10001000100010101010001000101010100000000000001
11101011111010101011101110111010101110101111101
10000010100000101010101010000000000010100000101
10101010111011101010101010101011101111111011111
10101000000000000000000000101010000000001000001
11111111111111111111111111111111111111111111111
