11111111111111111111111111111111111111111111111
10000000000000000000000000000000000000000000001
10101011101010111110111110111111101010111111101
10101000101010001000000010100000001010100000001
11111011111010101111101111101011101111101111111
10000000001010100000100000101000100000100000001
11111111101110111110111111101010111111101011101
10000000000010000010001000001010001000001000101
11101011111110111010101111111011101010101010111
10001010000000001010100010000000101010101010001
10111110111111101111111011101111111011111110101
10000010000010001000000000100000001010000000101
10111110111011111110101010111110111111111110101
10100000100000000010101010100000000000000010101
10101010101110111111101111101010101110101110111
10101010100010100000000000101010100010101000001
10101011101110111111101010111111111111101110101
10101000100010100000001010000010000000000010101
11101011111011101011101110101010101111101010101
10001000001000101010001000101010100000101010101
10101010101011111110111111111111101111101111101
10101010101000000010000000000010000000101000001
10101111101110101110101110111110101110111011101
10101000000010101000101000100000100010001010001
10111110101011101111111010101011111011101111101
10000010101010000000100010101010000000100010001
11111110101111111010111110101011101010101110101
10000000100010000010001000101000101010100010101
10111110111011101010101010101110101011101110101
10001000100010001010101010100010101010000010101
10111110101011101010101111101010111011101111101
10001000101010001010101000001010100010001000001
11111010101111101011111011111111111011111011111
10000010100000101000001010000000000000100000001
11101010111110111111111011101110111010111010101
10001010100000000000100000101000001010001010101
10101011101011101010101011101110101110101010101
10101000101000101010101010001000101000101010101
11101110101111111110101110101010111110101111101
10001000101000000000100010101010100000100000101
10101010111110111110101010111111111110101010111
10101010001000000010101010001000000000101010001
10101111101110111011101011111011101010101110111
10101000001000100000101000001000101010101000001
11101010111011101110101110101010101110111110101
10001010100000101000101000101010101000100000101
11111111111111111111111111111111111111111111111
