11111111111111111111111111111111111111111111111
10000000100010000010001010000010101000000000101
11101011101110111010111011111010101011111011101
10001010101000101010001010100010001010000000101
11111010101011101111101010101111101111111011101
10001000000000001000001000000010000000100000001
11101011111110111011101110111110101111101111101
10100000001000000010001000100010100010001000101
10111110111111111111111110111010111010111110111
10001000100000000000101000001000101010000000001
11101010111010111011101010101010101111111011101
10000010001010001000000010101010000000100000101
10101111101111111110111110101010111010101110111
10100000100000000000100000101010100010001000101
11101111101010111111111110111011111111101110101
10000010001010001000000000100010101000101010001
10111011111010101110101011111110101010111010111
10100010101010101010101000001010100010101000001
11101010101111101011101110111010101010101110111
10001000001010000010100010000000101010000000001
11111011111011101010101111101010111011111110101
10001010001000001010001000001010001000001010101
11101010111111101111111110111010111010101010111
10001000001000101000001000100010100010100010101
10101110111011101011111111111011101011111111101
10100010101000000000101010000010001010001010101
11101111101111111110101011101110101111101010101
10000010101000100010100000001000101010001000001
11111010101011111011111110111010111010111010111
10100010000010100010001000000010100010100010101
10101010101010101110111011111110101010111110101
10101000101000101000001000000010101000000000001
10111011111110101111101011101111111011101110111
10000010000000000010001010000000101010001010001
10111111101111111010101011111011101011111011111
10000010001000101010101000001010000010000000101
11111110111011101111101111111010111111101110101
10000010001010100010000000000010000000101010001
10101010111010101011111011111010111011101010101
10101010001000001000001010000000001000001000101
10111010101110111010111111101111101111101010111
10001000101000100010000010101010001000001010001
11111010111111101110111010101010101110111011101
10000010000010000010100010000010100010001010101
10111011111010111011101111101111111010111010111
10001000100000001010000000001000000010100000001
11111111111111111111111111111111111111111111111
