11111111111111111111111111111111111111111111111
10000010101010101000100000100000100010000000001
11101110101010101011111011111010101111101110101
10001000100010000010000000100010100000000010101
11101011101110111110101110111110101110111110101
10001000000000100000100010100000000010001010101
11101110101111101110101110101111111011101010111
10100010101000101000100010100000100000101000001
10111010111011111111101011111110111011111010101
10001000101010101010001000000010100000001010101
10111110101010101011111111111010101011111011101
10100010000000001010100000000000101000100000101
10101111101011111010111010111010111111101111111
10000000001000000000000010101010001000101000001
11101111101111111010111010101011111011111111101
10000000101010001010101010100010000000100000001
10111110111011101111101111101010111110101111111
10000010000010101000000000101010001000000000101
10101110111010101010101111111111101111111110101
10101000100000100010101010000010000010100000101
11101111101011101011111011111010111110101111101
10000010001010001010001010100010000010101010001
10111111101111111010101010111011111010111010111
10101000001000001000100010001010000010000000001
10101110111011111010101010101011101110111011101
10100000100000100010101010100000000000100000101
10101111101111111111101111101110111010111111111
10100000000000100000101010000010001010000010001
11101011111110111010101010111011111011101010111
10001000100000001010001000100010000010001010001
11101010111011101011101010101111111111111010111
10001010100010101010101010101000101010101000001
11111011101010101010111011111010101010101011111
10000010001000101000100000001010001000001010001
10101111111110101110101110101010111111101111101
10100000101000100010101000101010100010000000001
10111111101011101010101111111011101111101110101
10100000100010101000000000000010001000101010101
11101111111010101111101111101110111110111011101
10000010101000101000101010001010000000000000001
11101110101111111011101010111011101110111110111
10001000100000000010000010000010101010001000001
10111010101110111110111111101010111010101010101
10001010001000000010100000001000000010101010101
11101011101111111011111110111110101111101110111
10000000101000000000000000001000100000001000001
11111111111111111111111111111111111111111111111
