11111111111111111111111111111111111111111111111
10101010101010001000100000001000100010000000101
10101010101010111011101010111011101110101010101
10001000001000101000001010001000000000101010101
11101110111110101111101111111010101011101111101
10000000101010001010001000100010101000101000001
11111010101011101011101011101111111111111110111
10000010000010100010000000000000001010100000001
11101110111110111011111010111111111010101111111
10001010001000001000000010001000001000000010001
11111010111111101010101011101110101010111111101
10000000100000101010101000100010101010101010001
10101110111011101110111110111110111011101011101
10101000001000001010000010100000101010101000001
10111111101111101011101111101110101010101011101
10001000000010100000101000101010000010101010001
11111011111010111110101110101011101110101111101
10101000001000001000001000100010101000000000101
10101111111110101110111110101110111010111111101
10100000100000101000100000000000000010101010001
10111011111110111011101110101011111011101011101
10001010100000000000000010101000100000000000001
10101010101111101111101110101111111110111111101
10101000101000101010101000100000001010000000101
10111010111110101010111111101011111010111011101
10100010001010000010101000101010001000001000101
10111110111011101110101011111110111110111011111
10100000000010100000000000001000001000101000001
10101011101110101010101111111010111111101110111
10001010100000001010100000101010000000100010101
11101110111111101111101111101011111011111010101
10001010000000000000100000000010000000001010101
11101011101011101010111111101011111111111011101
10000010001010101010100010001010100000100000001
10101011101110101110101111111110111011101010111
10101010000010001000001000101010000010101010001
11111011101010101110111110101010101010101110111
10001000101010101000000010001010101010001000001
10101011101111111010111010111010111110101111111
10100010000010000010101000001010000000101000001
11101010101010101010101011101010111010111010111
10001010101010101010100000100000100010001010101
10101010111111101111101011101010111111111011101
10101010100000001000001000101010000000100000001
10101111101011101110101010101111111110101011101
10101000001010001000101010100000100000001000101
11111111111111111111111111111111111111111111111
