11111111111111111111111111111111111111111111111
10000010000010000010000000100010001000000010001
10111010101010111011111010111011101011111011101
10100010101010100000001010001000100010000000101
10101110101010111111101011101010111010111110101
10101000101010100000100010001010001010001010001
10101011101110101010101111111111101011101011111
10101000100000101010001000000000100000101000001
10111011111011101011111011111110111110101111101
10000010001010001000001000000010001000100000001
11111110101110111111111011111111101011111110111
10100000100010000000000010000000001000100000101
10101111111010111111111110111111111110101011101
10100010001000101000100010001000000000101010001
10111011101010101010101111101011111111101011101
10000000001010100010100000101000100010001000001
10111111111010111110101110101110101110111111111
10101000001010000010101010001010000010001000001
10101011101111111010101011111011111010101011101
10100000100000000010101010000000000010100010101
10111110111011111110101010111011111110111110101
10100010100010000000101000100010000010100000001
10101010111110111111101111101111111010101111111
10101010000010000010001000001000001000101000001
10111011111011111010111011111011101011111011101
10000000001000001010001000000000101000000010001
11111111101110111011101110111111101111111110111
10000000100010001000100010001000100000100010001
10111011111011101110111011101010111110101111111
10001010000010100000100000101010000000001000001
10101110111010111010101111101011111111111010101
10100000100010100010100000001010100000100010101
11111011101110111010111111111010101011101111101
10001000100010001010100000100010001000100000101
10111110101011101110101110101111101110111110101
10001000101000100010101010101000100010000010101
11101011111110111010101010101010111011111010101
10000000100010101010100010001010001010000000101
10111111101010101011111111111011101011101111101
10001000001010001000100000100010001010001000001
11111011111111101010101011101110111010111110111
10000010000000001010001000101000100010000010001
10101110111011111111111010101011111111111011111
10100010001010000000001010001000000010000000001
10101111111011101011101011111110111010111111101
10100000000000001000100010000000001000100000001
11111111111111111111111111111111111111111111111
