111111111111111111111111111111111111111111111
100010000000100000001000100010001010000010001
101011111110101111101110101110101010111110101
101000000010100010000000101000100010000010101
101111111010111010111111101010111011111010101
100000101010001010100000101010001010000000101
111110101010101010111010101011111011111111101
100000001000100010001010100010000000001010001
101111111111111011101011101110111111101010111
100000000010001010001000001010001000101010001
111111111010101011111110111011101010101011101
100010000010100010000010000000100010100000001
101110111110111110101011111111111110111111111
100000100000100010101000001000001000100010001
111110101111101010101111101010111011101010101
101000100000101010100000101010000010001000101
101011111110101010111110101110101110111011111
101010000010001000100010100010100000101000001
101011111011111111101011101010111111101011101
101000001000000000101000001010000000100010001
101111101111111010101111111011111110111111111
100000100000001010100000100010000010001000001
111010111111101010111110101110111010101011101
100010100000001010001000100000101010101000101
101110101111111011101011111111101010101110101
100010101000000010001000100010001010100010101
111010101011111111111110111010101110111010101
100010001000100000100010000010100010001000101
101111111010101110101110111110101011111111101
101000001010100010100010001000101010000000001
101011101010101110111011101011111010111110111
101010100010001000100000101010000010100010001
101010111111111011111110101011111110101011101
100010001000000010000000101000000000101010001
111110101011111110111110101111101111111010111
100000101010001000100000100000000010000010101
101111101010101011101011111111111010111110101
101010001000101010101000001000101010100000001
101010111110101010101111101010101010111111111
101010100010101000101000001010101010000010001
101010101011101110101011111010101011111010101
100010101010001000101000001010101000001010101
111110101010101011101111101010101011111010101
100000001000100010000000100010001000000000101
111111111111111111111111111111111111111111111
