111111111111111111111111111111111111111111111
100010101010000000001000100000001000000000101
101110101010111110111110101111101011111111101
100010101000001000100010101010101000101010101
101010101110111111111010101010111011101010101
101010000010100010100000000000001010100010101
111011111010101110111011111011101010101110101
101000100010000000000010100010000000000000001
101110111010111111101010101110101111101010101
100000001000000000101010101000100000101010101
101010111011101111111110111011101011111011101
101010000000100000000000001010001010001000101
111110101110111010111010111111101010111011101
100000100010100010001010000010101000001010001
101110111011111111101111111010111010101111111
101000001010001010100000001000101010101000101
101110101111101010111111111110101111111011101
100010100000100000100010001010000000101000001
111110101010101111101010111010111010101011111
101000101010000000101000001000001010000000001
101110111110101011111011111111101111111111111
100000000010101010101000101000101010001010001
101111101011111010101011101110111011101010111
100010001010100000000000100010100010000000001
111110111110101010101011101110111010111111111
101010100000001010101000000000000010001010101
101010111110111010111010111110101010111010101
101000001000101010001010100010101000001000001
101011101110101111111011101111111111111011111
100000101000100010000000001010101010001000001
111111101110101111101010111010101010111011101
101000101000001000001010000000000000000000101
101011101110101111101110111110101011101010111
100000001000100000100010101000101000101010001
101111101110101110101110101110101011111111111
101000001000101010101010000010101000100000001
101111111111101010111011101010101111101111111
101000000000000010000000101010100000000000101
111110111111101111101011111011101010111011101
100000100000000000101010001000101010001000001
111110111111101111101110111011101110111011111
101000100000000010000000101000101000001000001
101110111010101110101011101110101110101011101
100000001010100010101000000010101000101000101
111111111111111111111111111111111111111111111
