111111111111111111111111111111111111111111111
100000000010100000100010100000101000100000001
101111111110101111101110111110101010101111101
100010101000101010100010101000100010000010001
111010101010101010101110101110101110111110101
100010101010100000001000000000100010101010101
111010101010111010111010111111101010101010111
100000101010001010101010100000001010000010001
111011101110111110101011111111101011111111111
100010100000000010000000100000101000100000001
101010101010111010101111101110101111101011111
101000001010101010101000100010000000101010001
111011111011101010111011111111101110101111101
101010100010001000001010000010000010001010001
101110101010111111101011111010111111101010111
101000101000100010000010001010000000101000001
101011111011111010101010101011101011111011101
100000000000000010101000100000001010000010001
111010111010111111101111111010111110101110101
100010100010100000000010100010101000101010101
111011101011111111111010101110101011111011101
100010001000001010100010001010000000101000001
111111111111101010111011111011101111101110101
100000101010001000100000100010101000101000101
111110101011111011111111101110101011101111101
101000000000101000000000000010000000100010001
101011101010101011111011111110101011111010111
100010101010100000001000001010101010101000001
111110101111111111101111111011111010101110111
100010001000001000000000001010101000100000001
101010111011111111101111101010101111111111101
101010001000000000001010000000001000000010101
111010101011111111101011101011111011101010101
101000101000100000100010101010100000101000001
101011101110111110101010111010111110101110101
100010000010101000001000100000001000101000101
111010101110101110101010111110111111111110111
100010100010100000101010101000001000100000001
111011101011111010111111101110111110111011101
101010001000000010100000101000100000000000101
101011111011101111111110101011101111101110111
100010001010001010001000001000100010001010001
101011101110101010101111101110101111111011101
101000100000100010100000000000000010000000001
111111111111111111111111111111111111111111111
