111111111111111111111111111111111111111111111
100010000000100000001000001000001000000000001
101110111011101111101011101010111011111011101
100000101000001000101010100010000010001010101
101111101111111010101010111111111111101010101
100000101000100010100010001000100000001010001
111110101010101010111110101010101011101010111
100010100010001010001000100010001010101010001
101010111011111011111011111111111010101011111
101010001010000010001000100000100010001000001
101111101110111110101011101110101110111111101
100000001000100010101010001000001000100010001
101111111011101010101010111111111111101110111
100010100010001000101010001000000000001000101
111010101010111111101011101011111111111110101
101010001010100000101010001010000000000010101
101011101010111011101010101011111010111010101
101000101010001010001010101000001010001000101
101110111011101010111010111111101111101111101
100010100010001010000010000000101000100010001
101110101010111011111111111011101010111010101
100000101010000010100000001000100010000010101
101111101111111010101111101010111111111110101
101000000000000000101010001010000000100000101
101111111111101111101010111110111110111011101
100010000000100010001000100000100010001010001
111010111110111110111011101111111011101011101
101010100010100010001010001000000000101000101
101010101010101011101010111011111111101010101
100010001010101000001010101000100000101010101
101111111010101111111010101010101110101110101
100000100010101000101000100010001010101000101
111110101110101010101111111011111010101011101
100010100010101010100000001000000010101000101
101010111010101010101111101110111110101010111
101010100010101010001000101000100000101010001
101010101110101011111110101111101111101011101
101010001010001010000010000000101000001010001
101111111011111010111011111110101011111110101
100000000000100010001000000010001010000010101
101110111111101011101111111010111010111010101
100010100010001000001000100010100010001010101
111010101010111111111010101111101111101010101
100010001000000000000010100000000000001000101
111111111111111111111111111111111111111111111
