111111111111111111111111111111111111111111111
100000001000000000101000000010001000000000001
101111101110111111101110111010111011101111111
101010001010001010000000100010100010100000001
101010111010101011101111111010101110101110111
101000001010101000001000000000101010001000001
101111101010111010111110111011101010111110111
101000100000101010101000101010001000001000101
111011111010101111101110101111111111101111101
100000000010001000001000101000101010100000001
101010111011101011101110101110101010101110101
101010001000100000101000001010100000101010101
111011111111101111101010111010111110111011101
100010000010100000101010001000100010001000001
111010111110111111101011101110111011101011111
100000000010100010100000100000101000001010001
101011111110101110101111101110101010101011101
101000101010000010001010001000000010100000101
111110101011101010111011101110111111111110101
100000101000101000001010001010001000001010001
101111101110111010111011101010101010101010111
101000100000101010000010101000101010100010001
111110101011101010111010111111101011111010111
100000101000100010100010100000100000101010001
111011111110101011101110101111111010101111111
100010000000101000100000100000100010100000101
101111111110101011111111111010111111101110101
100000101010001010001000000010001000101010001
101010101010111010101010111110111110101011111
101010001000001010101010100000100000000010001
101011111110111111101111101111101011101011101
101000000010000000100010101000101010001000001
111010101110101110111010101110101110111110111
100010100010100010100000000010100010100000001
101111101111101110111110111010101110111011101
101000000000001000101000100000001010100010001
101111111110111111101011101010111011111111101
100010100010001000100000101010000000100010001
101110111010111110111110111111111011111010111
100010000000000000000010000000101010000010001
101110111010111110101011111110101110101110101
100010001010001000101000000010101010100000101
101011111011101110111111111011101010111111111
101000100000101000001000000000000000000000001
111111111111111111111111111111111111111111111
