111111111111111111111111111111111111111111111
101000001000000010000000001010000000001000001
101010101011101010111011101010101111111010101
101010101010001010100010101010101000001010101
101010111010111011101110101010101011101010111
100010001010100010001000101010100010001010001
101111101010101110111010101010111110111011101
100010100010100000100010101010001010001000101
111010111110111111111011101011101011101110101
101000000010000000001000001000101000100010101
101111111011111111101011111010101010111010101
100000100000001000001010100010100010001010101
101110101111111011111010101011111111101010101
101010101010000010001010001000001000101000101
101010101010111110101011111111101010101111101
100010000010100000100000001000101010000000101
111011111110111111111111101010101011111110101
100010000000100000000000101010101010001000101
101110111111101111111110101010101010101011101
100010001000001000001010100010100010101000101
101111101011111011101010111110111110101111101
101000101000100000100010000010100010100000001
101010101110101110111011111010101010111111101
101010000010101000100000001010001000100000101
111011111010101011111111101011111111101011101
100010100010101000000010101000000000101000101
101110101111101111111010101111111110101110101
101000001000101000001010000000100000100010001
101111111010101011101010111111101111111011111
101000100010101010000010100000001000001000101
101010101110101011111110101111111011101110101
100010001000101000101000100000100010100010101
101111111011101110101011111110101110111010101
101000001000101000100010001000100010000010101
101110101110101011101110101011111010111110101
101000100010001010101000100010000010100000101
101011111011111010101011111111101110101111101
100010001010100010001000100000001000100000001
111110111010101110111110101111111011111111101
100010001010101000001000100000100010000010101
101110101010101011111011101110101110101010101
101000101000101000100010100010100010101000101
101011101110101111101110111010111110101111101
100000100000100000001000000010000000100000001
111111111111111111111111111111111111111111111
