111111111111111111111111111111111111111111111
101000001010001000001000000000100010000000001
101011101010101011101111111110111011111011101
100010001000100010000000100010001000000010001
111110111011111111101110101011101111111110111
100000000010000000100010101000100010001000101
101011111111101110111010101010111010101011101
101010000000001000001010101010000010101000101
101011111010111011101010101011111110111010101
101000001010100010000010001000000010001010001
101111101011101111111111111111111011101011101
101000101010001000001010000000001000001010001
101110101010101111101010111011101011111011101
100000101010100000100000101000101000001000101
111110101110111011111111101111101111101110111
101000100010001010001000100000000000100010001
101011111010101010111010101110111111111011101
100000001010101010001010101000100000001010001
111111101010101011101010101011111111101010111
100000101010101000100010001010000000001010101
111110101010101110111111111010111111101010101
100000101010101000100000100010001000101010001
101111111011101011101010101111101011101010111
100000001000101010001010101010001000001010001
111111101010111010111010101010111011111010101
100000100010001000100010001000100000100010101
111110101111101011111110111011111110111111101
100000101000001010000010100010000010000000101
101111111011111011101011101110111011111110101
100000100010001000001000101000100010001000101
111110101110101111111110101011101110101011101
100010001000101000000010101010100000100010001
101011111111101011111010111010111110111110111
101000000010001000100010000010001010100000001
101111111010111110101111101110101010101111111
100010001000001000101000001000101000100010001
101010101111101011101011101011101111101010101
101000100000100010001000101000101010001000101
101111111110111110111110101111101010111111101
100010001000100010000010100000001010000000101
111110101011111011101110111110111011111110101
100000101010001000001000100010100010001000101
101111111010101111111011111011101010101110101
100000000000100000000000000000001000100000101
111111111111111111111111111111111111111111111
