111111111111111111111111111111111111111111111
101000101000001000101000000000101000100010001
101110101111101011101110101110101110101110111
100000101000100000100000101000101000101010001
101110101110101010111110111111101110101010111
101000001000001010101010101000100000000000001
101110101110111111101010101011111110111011111
101010101000000010101000000000000010101000001
101010101011101010101011111111101010101011111
101000101000101000101000100010101000101000001
101011101111111110101110111010111110101011101
101000101000000000100000101010100010101010001
101110101011111111101011101010111010101011101
101000100000000000001000000000100000100010001
111111111111111111111111111110111111111111111
100010100000001010001010101010000010101010101
101110111010101011101010101010111010101010101
100000001010101000001000101010001010101000101
111011101010101110111011101011101010101011101
100000100010100000000000000000001010100000001
101111111111101111111111111111111110101111111
100000100000100010100010101010001010100000001
101011111110111010101010101010111010101010101
101000101010100000001000001010001010101010101
111110101010111111111011111011101010111011111
100010101000100000000000001000101010100000001
101010101110101011111111101010101010111111101
101000100000101010100000001010001010100000001
101111101111111010111011101010111010111011111
100000100000000010101000100010001010100000001
111010101111101110101011101011101010101111101
100010100000100010100000101010001010101010001
101110111110101110111011101011101010101011101
100010100000100010000000101010101010100010001
111110111011101011111011111010101010101111111
100010101000101010000000001010001000100000001
111010101010111111111110111110111010111011111
100000100010100000000000000010000010100000001
111110101111111111111011111111111010101010111
100010100000100000000000100000101010101010001
101110111110101110101011111110101010101111101
100000100010100010101000001010001010000010001
101110101010101010101010101010101010101111111
100010101000101010101010100000101010100000001
111111111111111111111111111111111111111111111
