111111111111111111111111111111111111111111111
100000000000000000000000000000000000000000001
101011101110111010101010111011111111101110111
101010000010001010101010001010000000001000001
111111101110111010101110101110101010101010111
100000001000100010101000101000101010101010001
111010111111101111101010101110101011111110101
100010100000001000001010101000101010000000101
101010101011101010111011111010101010101111101
101010101000101010001000001010101010100000101
101011111011111111111010101110101011101010101
101010000000000000100010101000101000101010101
111011111010111011111111101111101111101011101
100000001010100000001000000010000000101010001
101010101011111011111111101010101111101110111
101010101000100000000000101010101000000010001
101111101011111010111011101111111110101011111
100010001000001010001010000000000010101000001
101110101011101010101011101110101011111111101
101000101000101010101000100010101010000000001
111010101111111011111111111110101011101011101
100010101000000000000000000010101010001010001
111011101110101110101011101010101110111110111
100000101000101000101010001010100010100000001
101010101011111110101110101111111011111011101
101010101010000000100010101000000000001000101
111011101010111011111110111110111011101010101
100010001010100000100000100000001000101010101
111011101010101110101010111011111011101011101
100000101010100010101010001000001010001010001
101111101110111110101110111110111111111010101
100000100010001000101000000010000000001010101
101110101111101011101110111110111011101111101
100010100000101000100010100000001000101000001
101010101111111110101110101111111110101110101
101010100000001000101000101000000000101000101
101010111011101111111110111010111011111010101
101010100010000010000000001010100000001010101
111110101010111010101111101010111010111010111
100000101010100010100010001010100010001010001
101010101011111010101011101110111111101110111
101010101010000010101000100010000010000010001
101011111110101111101011111010101110101110101
101010000000101000001010000010100010100010101
111111111111111111111111111111111111111111111
