111111111111111111111111111111111111111111111
100000001000000000001000000000001000000000001
111011101011111110101111111011101111111110101
100010001010100000101000001000100000100010101
101110111010101111101011101010111110101010101
101000100000101000101010001010000010001000101
101111101111101010101010111110111011111111101
100000000010001010001010000010001000100000001
111111111110111011111011111011111110101111111
100000000000101000000010001000001000100000001
101111111111101111111110101111101011111111101
101000000000000010000000100000101010000010101
101111111110111010111111111011101011101010101
100000100010001000001000100010001000101000101
101110101011101111111010101110111110101110101
100010001010001000100010001000100010101000101
111011111010111011101111101011101010101011101
101010001010100010001010001010001000101000101
101010101010101110111010111010111111101011101
100010101010100010001010001010100000001010001
101111101010111011101011101010111110111110111
100000001010000000101000001000100000100010001
111110111011111110101111111111101110101011101
101000100010000010101000000010001000101000101
101011101110101110101011101011101110101011101
101000101000100000101010001000100010101000101
101110101011111111101010111110111010101110101
101000101000100000101010001000000010100010001
101011101111101110101011101111111111111011111
100010100000000010101000100000001000001000101
101110111111111110101011111011101010101110101
101000000000100000100010001000100010100010101
101110111110101111101110101110111110111110101
100010100010101000000010100010000010000010001
111011101010101111111010111011101111111011101
101000001000100000001010001010101000000000101
101111111110111111101011101010101011111111101
100000000010100000101010001010101000000010001
101111111010101111101111111010101111111010111
101000001000100010001000001010101000101000101
101011101111111010111010111010101010101111101
101010001000000010001010100010001010100000101
101110101011111011101010101110111010111010101
100000100010000000100010001000000010000010001
111111111111111111111111111111111111111111111
