111111111111111111111111111111111111111111111
100000001000000010000000001000100000000010001
101111101011111010111110101010111111101011101
101000001000100010100010100010000000001000001
101110111110111110101010111111111111111111101
100010000000100000001010001000000000000000101
101011101111101111111111101011111111111110101
101010101000100010001000101010000010000000101
111010101010101110101010101010111010111111101
100010001010001000101010100010100010101000001
101011111011111011101010111110101110101011111
101010000010000010001010000010101000100010001
101110111110111110111011111010101110101111101
100010001010100010000010000000100000100000101
111011101010101011111110111111111111111110101
100010001010101010001000001000000000001000101
101110111010101110101011111011111111101011101
101000100010100000100010000000100010001000001
101011101010111111111010111111101010111111111
101010101010000000001010001000001010000000001
101010101011111111101111101011111011111111101
100010001000000010100000001010001000000000001
101110111011111010111111111010101111111111111
100010100010001010100010000010100000001000001
111011101110101010101010111111101111101111101
101000100010100000101000100000001000100000001
101110101011111110101111111011111011111111101
100010101010001010100010000010000000000000101
111010111010101010111010101111101111111011101
100010001000101000001010100000101000001000001
101011101110101111111010111110101110101111111
101000100010101000000010100000100010100010001
101111111011101011111111101111111010111110101
101000001000001010000000001010000010000000101
101010101111101011111110111010111111101111101
100010101000001010001000100010100000101000101
101110111011111010101011101010101110101010101
101000100010001010100010001000101000101010001
101010101110101110111110111111101011111011101
101010100000100010000010100000101010001010001
101011111111111010111010101010101010101011111
101000100010001010001010101010101010101000001
101110101010101011111010111010101010101111101
100010001000100000000010000010001000100000001
111111111111111111111111111111111111111111111
