111111111111111111111111111111111111111111111
100000001000000000000000000010000000000010001
101111111011111011111111111011101111111010101
100010001010100010000010001000001000100010101
101010101010101110111010101111111010101111101
101000100010100010100000100010000010100000101
101111111110111010111111111110101111111110101
100000001000100010000010000010100000000010001
101111101110101111111010111010111111111011101
101010100000101000000010101000100010001010001
111010111011101010101110101111101011101010111
100010000010001010101000100010001000001010001
101111111010111010111011101010111111101011101
100000001010100010001000001010100000001010001
111111101010111111101111111010111111111010111
100010001010100010001000100000100000000010001
101110111010101010111010101111101111101111101
101000100010001010000010001000100000101000001
101011111011111011111011111010111110101011111
101000001000001000001010000010000010101000101
101111101111111111101110111111111010111110101
101000100010000000001000100000001010000010001
101010111010111111111011111011111011111011101
100010001010100000000000001000000000000000101
101111101010111110111111101111111111111110101
100000100010000010100000100000000000001000101
111110111110111011101110111110111110101011101
100010000010001000001000100010100010101000101
101011111011101111111010101011101010101111101
101010000010001000001010101000001010100000101
101010111110111111101010101111111010111110101
101010000010000000101010101000001010100000101
101111111011111110101011101011111011101111101
101000001000100010001000000010001000100010001
101011101110101010111110111110101110111010111
100010000010101000100010100000100000100010101
101110111010111111101011101111111111101010101
100010101010100010001000100010000000101010101
111010101010101010111110101010111110101010101
100010100010001000100010101010001000001010001
101110111111111111101110101010101111111111101
100010000010000000001000101010101000000000101
111011111010111111101011111010101011111011101
100000001000000000100000000010100000001000001
111111111111111111111111111111111111111111111
