111111111111111111111111111111111111111111111
100000101000001010000010000010001000000000101
101110101011101010111010111011101011111010101
100010100010001010001010100010000010001010101
111010101111111011101110101110111110101010101
101010100000000000100000100010100000101010001
101011111011101110111111111010101111101111111
101000000010100010000000000010001000100010001
101110111110111011111110111111111010111010101
100010000000001010100010000000000010001010101
111011101111101010101011101110111111101010101
100010001000001010001000101000100010100010101
101010111011111011101110111011111010111111101
101010101010001000001010001000000010100000001
111010101010101111111011101011111110101011111
100010101000100010000010101000100000101000001
101110101111111011101010101110101111101111101
101010000010001000001000101010100000000010001
101011111011101111111011101010111111111110111
100010001000100000100010001000100000000000001
111010101110101111101110111011101111111111101
101000100000100000001000101000101000000010101
101111111111111111111011101110101010111010101
101000100000001000100010000000100010100010101
101010101111101110101110111111111110101110101
101010000000101000100010100000000010100000101
101011111110101011111010101111111010111111101
100010001000101000000010100010000010001000001
101110101011101111101110101110111111101011111
101000101000100000101000101000100000101010001
101011101110111110101011101011101010101010101
101010001000100010101000101000001010001000101
101011111011111010101110111111111011111111101
101000001010000010101010100000001000100010001
101110111010111110101010101111101111101010111
100010100010001000101000100000100010001010001
111110101110111011101011111010111010111011101
100010101000100010001000000010001010001010001
101010101011101111101111111111101011101010101
101000100010001000000000000000101000101010101
101011111110101011111111111111101110101010101
101010000010101000100000100000101000101010101
101110101110101110101110101110101011101010101
100000100000100000100010000010001000001000101
111111111111111111111111111111111111111111111
