111111111111111111111111111111111111111111111
101000100000001000100000000000101010001000101
101110101010111011101110111011101010101110101
100000101010101010101000100000101000100010001
101111101111101010111111111011101110111111101
101000100010100000001010000000101000001000001
101110101110111011111011111010101110111110111
101000000000101000001000101010000000000010001
101011111111101011111011101111101110111110111
100000101010101000100010001000001010101010001
101111101010101011101111101011101011101010111
101010100010101010100010001000101010101000101
101010111010101010101111101011111010101011101
101000001000001010101010101010000000100000001
101110111110111010101010101011111011111010111
101000001010101000100010000000001000000010001
101011111010101110101110111111111011101011111
100000100000100010101000001010001010101000001
101111111110101110101011111010111010111011101
100000100000000000000010100000100000100000101
111110111110111011111110111011101011111111111
101010101010001000001000000000001000000000001
101010101011101010111110101110111111111011111
100000101000101010001000100010100000101000001
101110101011111111101011111111101111101110111
101000000010001000100000000010001010001000001
101011101010111110101011111111101011101111111
101010001010101010001010000010000010100000001
111111111010101010101110111111111010101111111
100010000000100000100010000010100010000000001
111011111011111011111110111110111011101110111
100010000010000000101000001000001000000010101
101111111011111110101011101011101011111111101
100000101000001010101010101000101000101000101
111110101011111010101010111011111011101011101
101000100000000000000000000000000000000000001
101110101011101111101111101110111110101010111
100000001000100000100000100010100010101010001
111011101111111011101011111111111011111111101
100010000000101010101000000000000010001010101
111111111011101010111111111010111111101010111
101000001010000000000000001010000000001010101
101110111011111010111010111010101110101010101
100000000000001010100010001010101000100000001
111111111111111111111111111111111111111111111
