111111111111111111111111111111111111111111111
100000000010001010000010000000100000001000001
111011111010101010111010101111101011101011101
100010100010100010001000101000001010000010001
101110101110111111101111101011111011111110111
100010000000100000001000100000100010000010101
111011111011101111111110111111101110111010101
100010001010001000000000100000001000100010001
101010101010111011101111101011111011101111101
101010101010100000101000001010001010101000001
101110101010111110101011101110101010101011111
100000101010100010101000101000100000101000101
101111101010101010101110111011111111101110101
101010001010001010101010000010100000101000101
101010111011111010101011111110101110101110101
101010101010000010100010000000100010100010101
101010101010111110111010111011111010111010101
101010100010100010001010100010000010100010001
101010111010111010101010101110111110101111101
101010001010001000101000101000101000101000001
101011101111101111101111111011101011101111101
100000100000100000101000000010001000100000101
111110111110111110101011111110111110111110111
101000000010000010101010000010000010000010001
101011111110111010101010111011111011111011101
100010000000100010001010001000001000001000001
101110111111111111101011101111101111101111101
100010000000100000001000000000100000100000001
111011111110101111101111111111101110111011111
101000000010001000100010000000100010001000001
101110111111111010101110111110111011101111111
100010100000000010101000100000101000100000001
101110101111111110111011101111101011111111101
100000100000001000000010001000000010000000001
101111111111101111111110111011111110111111101
100010000000100000100010101000100010001000101
111010111110111010101010101011101011101010101
100010100010001010101000101010001010001010001
101110111011101110101111101010111010111011111
101000101000101000101000100010101000101000101
101011101011101011101010111010101111101110101
101000001000100010101010001010101000100010001
101111111110111110101011101110101010101011101
100000000000000000100010000000100010001000001
111111111111111111111111111111111111111111111
