111111111111111111111111111111111111111111111
100000100000001010100010000010100000000010001
101011111110101010111010111110101111111110111
101000101000101000100000101000100000000010001
111011101110111011101110101011111110111111101
101000001010001000000010101000101000001000101
101110111011101111101011101011101011101110101
100000001000000010001000100000100000100000001
111011111011111011111110101111111110111111101
100010100010001010100000001000000000001000101
101110111010111110111011101011111110111110101
101000100010100000000000101010001000100010001
101011111010111010111011101110101011111011101
101010001000000010001000101010100000000010001
101011101110111011101010111010101110101111101
100010000000001010001010100010101000101000001
101110111111111111111011111011111110111111101
100000100000100000001010001010001010101000001
111110111011111110111111101010111010101111111
100010000010000010000010000000000010101000001
101010101110101111101110101110111110101110101
101010100010101000100010100010100000100000101
101111101011101010111010101111111110101010101
100000101000000010000010101000001000001010101
111011111110111010111111101010101011111110111
100000000000100010000010000010100010101010001
111110111110101110111010111011111110101010111
100000000010100010001010100000000010101000001
101010101011101010111011101110101010101111101
101010101010001010100000000010101000000000101
111111101111111010111011101111111011111010111
100000000010000010001010001010000010000010001
101010111011111011101110101011111110111011101
101010101000100010001010101000101000101010101
111110101110101111111011101011101111101010101
101000101000101000000010001010000000101010001
101011101011111111101111101010111010101011111
101010000000000010000010000010001010101000001
101011111011101110101110101111111110101010111
101010101010100000100010100000100000100010001
101110101010111111101010111110111110101111101
101000001000100010001010001000100010001000101
101110111011101011111110111011101111111110101
100000000000001010000000001010000000000000001
111111111111111111111111111111111111111111111
