111111111111111111111111111111111111111111111
100000000000000000000000000000000000000000001
101111111010111110111110111110111011111110111
100000100010100000100000000010100010000000001
101011111011101010111110101010111010111111101
101000100000101010100000101010100010001000001
101111101011101010101110111111101011101111101
100000101010001010100010000000101010000000101
101011101110101110101011111011101111111110101
101000101000101000101010000000100000001000101
101011111011101110101011101011101011111110111
101000001010000010101010001000101000100000001
101011111011101111111111111110111010111110101
101000001010000000000000001000001010100000101
101111101110111111101111111011101111101111101
100010001000000010000000001010000000100010001
101111101110111111111010111010101110111110101
101000001000100000000010100010100010100000101
111011111011101010111111111011101111101110101
100010000000101010000000100000100010001000101
111110111110111010101111111011101110101110111
100000000010100010100000100000101000101000001
101110111011101010111010111110101010101110101
100010100000101010001010100000101010101000101
101111101011111011101110101111101011101110101
101000001010000010001000100010001000100010101
101110111010101010111010111011101110111011101
101000100010101010001010100000101000001010001
101111111111111110111011101010111011111110111
100000000010000000001010001010001000001000001
111011101011101110111011111010101010111110101
100000101000101000100000100010101010100000101
111010111110101110111011111011101010101010111
100010100000101000001010000000101010101010001
101011101110101011101011111110111010111111101
101000101000101010001010000000001010100000001
101010111011111011101011101111111110111110101
101010001000100000101010000000000010001000101
101111111110101110111111101010111110111111101
100000000010101000000010001010001000000000101
101011111011111111111011111110101110101110101
101000001000000000100000100000101000101000101
101010111011111010101110111111111110101111101
101010100000001010101000001000000000101000001
111111111111111111111111111111111111111111111
