111111111111111111111111111111111111111111111
101010000000000010001010000010001010001000101
101011101111111111101011101110111011101110101
101010001000000000001000101000000000001010001
101010101011111011101010101110111110101011101
101000100000001000100010100010001000100000001
101111101111101111101110111011101011101111101
100000100000100000100010000010101000101000001
111011101111111010111111101110101011111111101
100000001010000010101000100010101000000000101
101111101011101111101010111110101110111111111
100000101010101000100010100000001000000010001
101110101010111110111110111111111111111010101
101010101000101000000000100010001000100010101
111010101011101110101111111011101010101010101
100000100000001010101000001000100010001000101
101011101111111010111010111011101111111111111
101000100010001000000010001000001010100010001
111010111111101110101110111011111010101111101
101010000000000010100010001000000000100000001
101010111010101110111110111011101110111110101
101010001010100000101000001010101000001000101
101111101010111011101010101010111110101010111
101010001010001010100010101010001010100010001
101010101011111010101010101110101011101110111
100000101000101010001010101000101000101010001
111110101110101011101011111111101110101011101
100010101000101000101010100000001010000000101
111010111110101111111110101111101011101111101
100000000010001010100010001000100000101000001
101110111110111010111010101110101110101110101
100010101000100010100000101000000010101000101
111010101010101110111111111010111010101111111
101010100010100000001000101010100010100000001
101110101111111110111011101111101011111110111
100000101000000000000000000000101000100000001
101110111111111110111111111011111110111110101
101000000010100000100000100000100000101000101
111011101110111010111011101111101011101011111
101000100010000010100000000000001000000000101
101011111011111010111011101110111011101111101
100000001000100010100000100010100000101000001
111110111011101111111110101111111110101011101
100000001000000000100000100010000000100000101
111111111111111111111111111111111111111111111
