111111111111111111111111111111111111111111111
101010100000000000100010001010000010000010001
101010111110101110111010101011101010111111101
101000100010101000000000101010001000101000001
101110101111111011111111111011111110101111101
100010100000100010001010100000001000001000001
101110101111101010101010101011101110111110111
100010100000001010100000001010101000001000001
101110101110101011101111111110101011111010111
100000101000101010000000101000001000000010001
111011111010111011101011101111101111101011101
100000000010100000101000001010000000001010001
101011111010111110111111111011111110111010101
101000100010101010001010000000100010101010101
101011101111101011111010111011101110101010101
101010000010001000001000100000000000100010101
101110111010111110101111101111111111101110111
100010001000000010101000100000100000001000001
111011111110111010111110111010111110111010111
100000001000001000000010000010100010001010101
111111101010111111101111101111101111111111101
100010001010101000100000101010100000001010101
111011111111101011111011101010101011101010101
101010001010001000100000000010101000101010001
101010111011101110111011101110111010101010111
100010001000000000000010000000000010100000001
111010111110111111111111101011111011111111111
100000000000101010000000001000001000001000001
101110111011101011101110101111111011111011111
101000001000001000000010100000100010100000001
101011101111111011111010111011111110101011101
101000100000001000100010101000100000001000101
111110111110111011111110101111101011101111111
100000100010101010000000001010001010001000001
111111101110101111111111101011101111101010111
100000000000000000001000101000101010100010001
101011111011101110111110111110101010101011111
101010000000101000100000000000100010001010001
111110111011111111101111101010101111111011101
100010101000000000100010101010100000100010101
111010101011101111111010101110101011111010101
100010100010100010000010101010001000101000101
101010111010101011101110101011101110101010101
101000100000101000000010000000100010001010001
111111111111111111111111111111111111111111111
