111111111111111111111111111111111111111111111
101010001010001000100000000000000000001000001
101011101011101110111111111110111010101110111
100000000000000010101000000000101010100000001
101010111111101110101111111011101110101011111
101010100010001000000000001010000000101000101
111111111011101111111011101111111011111110101
101000100000001000101010001010100000100000001
101110111011101110101111101010111011111011101
100000000010000000001000100000001000001010001
111111101111111110111011101011101011101010111
100000001000100000000000001010100000101010101
101011111010101010101011111110101011101110101
101010001010001010101010000000001010100010001
111111101110101111101011101110111110101111101
100000001010101000001010001000001000000010001
111111101011101110111110101110111011101111101
100000100000001000000010101010001000100010101
111110101110101111101111101010111110101110101
100000001000100000100010101000100000101000001
111111111011101110101110111110111110101110101
100010001000100010101000000000000010101000101
101111101010111111111011111011111011111010101
100000000010100000000010000000101000001010101
101010101111111110101011101111101010101110111
101010100010000000101010000010101010101000001
111111101111111011111111101110101110111010111
101010000000101000000010000010001010100010001
101010111111101010111111111011101010111110101
100000000010000010100000000010000010001000101
101010111111111011111110111011101011111011111
101010001000000000100000100010001000000000001
101010111111101110101011111110111011101011101
101010001000000010101000100000101010101000101
101011111111111011101110111010101010111110111
101010000000100000101000101010100000001000001
111011111010101110111111101011111010111110111
101010001010001010100000000000101010000010001
101011101111101011111011101110101010111011101
100000100000000000100010100010001010001010001
101011101110101111111010101110101110111111101
101000100010100000100010001010101000100000001
111110111010101010111011111010111111111010111
100000001010101010100010000000000010000010001
111111111111111111111111111111111111111111111
