111111111111111111111111111111111111111111111
100000000000001000100000100000001000100000001
111111101111101010101011101011101011101111101
100010000010001010001000001000100000001000001
101010111110111111111111111110111111111011111
101000100010000010000010000010001000000010001
101111111010111010111010111111101111111110101
101000000010001000001000001000100000000000101
101011111111101111111111101010101011111111101
101000101000100000001000001010001010000000101
101110101010111111101111111010111010101110101
101000100010001000100000001010101000101000101
101011101111101010111011101110101111101011101
100010001000101010000010001000100000101010001
101110111010111011111110111011101011101010111
100000100010000010100010101000101000001010001
111111101011111110101010101110101111111111101
101000001010000010001000000000100000001000001
101011111010111010111111111111111111101011111
100010001000100010100010001000001000001010001
101111101111101111101010101011101011111010101
101000100000101000001010101010001000100010101
101010101111101011111010101110111111101110101
100010100010001010000010100010001000100000101
111110111010111011111110111010101010111111101
100010001010100010000000101010101010100000101
101111101010101110111111101010101010101110101
100000001010101000000010001000100010101010001
101111111010101011111011101111111111101011111
101000000000100010000000101000001000001010001
101111111111111110111110101010111010111010101
100000100000100000100010101010100010001000101
111110101110101111101010101110101111101111101
100000101010100010001010100000100000100000101
101111111010111010101110101011111011111110101
100000000010001000101000101010001000100010001
111111111010111011111011101110101110111010111
100000100010100010000000101000100000100010001
101011101110101110111110101011111111101111101
101010000000100010001010100010000000000010001
101110111111111011101010111111111011111110111
100000100000001000100010000000000010000000101
111110101111111110111110101111111111111011101
100000100000000000100000100000000000000000001
111111111111111111111111111111111111111111111
