111111111111111111111111111111111111111111111
100010101000100010101000000000000000001010101
111010101010101110101010111010111110111010101
100000000010101000001010100010001010000000001
101111111111101011101111111011101010111010101
100010101010100010001000000010001000001010101
101010101010101111111011111011101010101010101
101000001000100000001000100010101010101010101
111011111011111111101011101010101111111011111
101000000000101010001000101010001000000000001
101111101011101011101111101111111110111011111
100010101000100010001000100010001010100000001
101010101110101011101110101110111010111011111
101000001000001000001000000000001000100000001
111111101111111111111111111110111011111011101
100010101000100010101010001000101000100010001
111010101011101110101011101011101110111011101
100010000000000010101010001000101000100010001
101011101011101110101010111011101111111111101
101000101000100000101000001000001000100000101
101110101110111010101010111111101011101010101
100010001000101010101010000000001000001010001
101111101111101010101111111110111111111111111
100010000000100010001000000010000010001000001
111110111111111111111011101010111010101110111
100010000000000010001010001010001000101000101
101011101011101110111010111010111011101110101
101010001010100000101010001000001000100000001
111010101010111010101111111111111110111111111
100000101010000010001000101000001000000000001
111111111111101111111011101011101111111111101
101000001010000010001000000010001010100010001
101010111010111010101110111111111010101010111
100010001010100000101000100000001000001010001
101010101011111011111010101111101111111011101
101010100010000000101010001010001010001010001
101111111111111011101011101011101010111011101
100010000000000010101000101000000010000010001
101111101011101110101110111111111011101110111
100010001010000000101000101000101010000010001
101111101010101010101011101110101010111110111
101000001010101010001000100010101000000000001
101010111011111011101011101010101110111111111
100010001010000000100000001000001000000000001
111111111111111111111111111111111111111111111
