111111111111111111111111111111111111111111111
100000000000001000001000100000100000000010001
101111111111101011111010101011101110111010101
100000100000001010001010101010001010001010101
111110101111111010101110101010111011101010101
100010100000001010100000101000100000001000101
101011101111101010111111101111101111111111101
101000001000001010100000100010001000100000001
101111111011111010101110101110111011101110111
101000100010000010000010101000101000001010101
101010101110101111111010101011101011111010101
101010000000100010001010001000101000000010001
101111111111111010101011111110101111111111111
100010000000001010101000001000001010000000001
101010101111111010111011111011101010111111111
101010100010000010000010000010000000100000001
111010111110111011111010111110111111101011101
100010000000100010001010001010100000001010001
101111111111101110101011101010111111111110111
101000000000101000101010100010000000100000101
101011111110101110101010101111111110101111101
101010100000100000101010100000001010001010001
101010101111111111111010111111101011101010101
101010101000001000001010100000001000001000101
101010101011101011101010101011111111111111101
100000100000101000101000101010100000000000101
101111111111101110101111101010101111111110101
101000000000100010101000001000101000000010101
101011111110111010101010111111101011111010101
101000100010001010100010100000101000100010101
111110101011101010111010101110101010101110101
100000101000100000100010001010100010101010001
101111111010111111101111111010111110101011111
101000001010000000101000000010100010101000001
101011101011111011101011111110101110101011101
101000101010001010001000001000100010101010001
101110101010101110101111101011111010111010111
100010101000100000100010001000100010000010001
111010111011111111111110111110101111101111101
100010001000000010000000001000101000000010001
101111101111111010111111101011101011111110111
101000001000001000000010001000001000100010001
101110101011101111111010111011111111101011101
100000101000100000000010001000000000001000001
111111111111111111111111111111111111111111111
