111111111111111111111111111111111111111111111
100000000000001010000010100010001010001010001
101010111110111010101110111011101010111010111
101010101000001010101000100000100000000000101
111111101011111011101110111010101111111010101
101010000010100000001000100010100000001010001
101011101110111111101110111011101110111111111
100010100000100010000010101000100010001000101
111010111110101011111010101110101111111110101
100010000000101010101000001010001010000010101
111011111110111010101011101011101011101110101
101010000000100000101010001010000000001000001
101011111110111010101011111011101011111111101
100010000010101010100000001000001010000000001
111011101110101110101111111110111110111110101
100000001010001000001010101000000000001010101
111111101010111111101010101110101110111010111
101010000000001000001000100000100010000010001
101011101011101111101011111011111111111111111
100000101010101000000010000000001010000010001
101110111110101010111011101111111011101111101
101010001010000010100010000010101010000000001
111011101011111111111011101110101011101111111
101000001000001010100000100000001010000000101
101111101010111010111110101110111011101111101
100010101010001000000010000010100000001000101
101110101110111111111011101111111011111011101
100000000000001000001010101010100000100000001
101011111111101111101010101010101110111010111
101010001010000010000000000000001010000010001
111111101011111010111111101111101011111010101
100010100000101010100010001000101000001010101
101010101110101011101110101011111110101011111
101000000010000010000010100000000000101000001
111010111110111011101111101110111011101111111
100010100000100000100000000010001010000000001
111111111010101011101111101110111111111110111
100000001010101000000010000010100010101000001
101111101111101010111111101110101110101110111
101010100000001010000010101000000000101010101
111010101010101110101010101110111110101011101
100000001010101000101010000010000010000000001
111111101010111010111010101110111111101010101
100000001010001010001010101000000000101010101
111111111111111111111111111111111111111111111
