111111111111111111111111111111111111111111111
101000000000101010000000100010001000001000001
101011111011101011101011111010111110101010101
100000101010000010001010001000100000101010101
101010101111101110101110111010111010101011111
101010001010000000100010001010000010100000101
111110111011101110111110111110111111101011101
100000000000101000001000000000000000101000101
111111111011101110101110111011101111111010101
100000000000101000100000001010101010100010001
111110111011111110111010111110111010111011111
100010001000100000100010000000000010000000001
111010101110101110111010111111101011111110101
100010101010100010101010000000101010001000101
111010101011111011101111111010111110111010111
100010100010100010000000100010000010001010001
101110101110101111111011101110111110101110101
100010100000000000001010101010000000100010101
101111111011111111111010101011111011111011111
100000100000100000100000101000000010000010101
111011101110101011101111101011111111111110101
100000100010101000000000001000100000100000001
101011111110111111101111101110101011111111101
101010001000000000100000101000001000100010001
111011101011101010111111111111101110101010101
100010000000101010001000100000100010001000101
111010111010111111101010101111111011111011111
100000001010100010001010100000100000101000101
101011111011101011111110111010101111101010101
101010001010101010000010000010000000100010001
111110111010111011101110111011111110111110101
101000000010001010000000100010001000100010101
101010101110111010101111111010101011101011101
101010100000001010100000100000101000001010001
101110111011101010111111101111111010101110101
100000001000101000000000100010001010101000101
101010101110111110111111101010101110111110111
101010101010100010100010001010101000001010101
101111101011101011101011101110101111101011101
100010100000101010001010000000101010000000001
111110101111111011101111111111111011101110111
100000000010000000001010001000100000001010001
111110111011101111101010101011111110101010111
100000001010000010000000100000000000100010001
111111111111111111111111111111111111111111111
