111111111111111111111111111111111111111111111
101010101010101000000010000000101000101010001
101010101010101011111111111011101011101011101
101010000010001010100010000000001000000000101
101010101110111010101110101011101011111010101
100000100000100010001000101010100000100010001
101110101110111011101111111010111111111111101
101000101000000000000010001010100000001010001
101010111011101010111110101010111110111010111
101010101010001010000010101000000010000010101
111010101111111011111110111010101011101111101
100010100010000010101000100010101010000000101
101011111010111010101010101110111011111011101
101010000010100000100010101000101010101000001
111010101111101010101111111010101110101011111
100000101000101010100000100010000010101010101
101010111010101011101110111110111110101010101
101010101010101000100010100000000010000000001
111110101110111111101011111110101010101110101
101000001000100000101010000000101010101010101
101011101011111110101110111110111010111011111
100010001000100010101000101000100000100010001
101011111011101110101010101010111110111010111
101000101000000000100010001010000010100000101
111011101111101111101111101110111011101011101
100000100000000000000000101010001000001000101
101111111110111010111010111011111010101110101
100000000010100010001010001010001010101000001
111111111010101010111111101010111111111011111
100000001000101010101010100000100000000000101
111110111011111111101010101111111111101111101
101000001000100000100000000010001010001010001
101110111011111110101111111010101011101010101
100010000000000000101010000000101010000010101
111011101110111111111010111010111010111010111
101000000010100010001000001010100000100010001
101110111111101011101011111011101111101010101
100000001000001010000010000000100000101010101
101110111111101110111111111011111111101010111
101000001000101010101000000000001010001000001
101111101011101011101010101011111010111011101
101010000010000000000010101000101000100010001
101010111111101110111111101110101011101111101
101000001000000010001000001000100010000010001
111111111111111111111111111111111111111111111
