111111111111111111111111111111111111111111111
100000000000100000100000001000000010000000001
101111111110101011101111101010101110111111101
100010000000101000001000100010101000100010101
111011101111111111111010111010111011101010101
100000101000000000001010001010001000001010001
101110101010111111101011101111101111111010111
101000100010000010100010000000001000000010101
101011111111111010111111111111111011111110101
101000000000001000100000000000000010000010001
101111111111101110101111111111111110101011111
100000101000001000100000001000000010101000001
111110101011111011111110111011111010101110111
100000001000100010001000000010001010101010001
111111111110111010101111111111101010101011101
100000000010001010100000000000001000101000101
101111111011101110111111111011111111101010101
101000001000001000100000001010000000001010101
101011101111111011101110101010101110111110101
100010001000000010001000101000101010001000101
111110111011111110111011111111101011101011101
100000101000000000100010000010000010001010101
101111101111111111111110101011111010111010101
100000100000000010000010101000001010000000101
101110101111111010111010111111101111111111101
101010101000100010001000001000001000000010001
101010101110101111101111101011111010111110111
101000100000100000001000101000000010000000101
101111111010111111111110101111111111111111101
101000000010100000000000101000001000100000101
101111101110101111111111101011101010101110101
100000101000100000100010001010001010101000001
111110111011111110101010111110101110111010101
100000000000000010001010100000100000100010101
111111111011111011111010101011101111101111101
100000000010001010100010001010001000001000001
101111111110111010101111111110111111101011111
101010000010100000100000100000001000101000001
101010101110101111111011101111101010101011101
101000101000101000001000001000100010001000101
101010111011101111101110111010111111111110111
101010100010000000100000100010101000000010001
101110101111111110111011101110101010111111101
100000100000000000100000100010000010000000001
111111111111111111111111111111111111111111111
