111111111111111111111111111111111111111111111
100000000000000000000000000000000000000000001
101111101111101111101011101011111010111010101
100010000010000000101010001000100010100010101
101011101011101110101010101011111011111111101
101010001010001000101010101010000000000010001
111011111110101010101011101010111110101010101
100010000000101010101000101010000010101010101
111110101110101011101111111111111110111010101
100000100010101010000000000010000000001010101
111011111110111111111111111111111010101010111
100010000000000010000000000000000010101010001
111110101110101011101111111111101010101010101
100000100010101010000010000000001010101010101
111010101111101111111010101110101110101010101
100010101000000000001010101000101000101010101
111110111010111110111010111010101010101111101
100000001010100000001010001010101010100010001
101010101011111110111011101110111110111111101
101010101000000010100010000010001000100000001
111010111011111111101011101111101110111010101
100010001010000000001000101000001000100010101
101111101011111011101011101010111011111010101
100010001000100000101000101010001000001010101
111010101110111010111110111010111110111111111
100010100010100010000010100010001000000000001
101010101011111010101010111111101110111010101
101010101010000010101010100000001000100010101
101011101010101110101111111110111010111011101
101000101010100010101000000000001010001000101
101111111110111111101011101110101111101110111
100000100000100000001010000010100010001000001
101110111010111111101111101110101010101110101
101000001010001000000000100010101010101000101
101010101011111011101011111111111010101010101
101010101000001010001000100000000010101010101
101110101111101110101111111110101110101111111
100010100000100010100000000010100010100000001
101010111110111010111011101010101110101011101
101010000010100010100010001010100010101000101
101011101011101011101010111011101011101111101
101010001010001010001010001000101010000000101
101111101111111110111011111111111110111111101
100010000000000010100000000010000000000010001
111111111111111111111111111111111111111111111
