111111111111111111111111111111111111111111111
100010000000100000001000000010000000100000001
101010111010101111101011111011101111101111101
101010001010101000101010001000001000100010001
101011101110101011101011101110111010111110111
101000100010001000000010001000100010001000101
101111111011101111111010101111101111101010101
100000000010100000001010100000001000100010101
111011111110111111101110111111111010111111101
100010100000000010001000100010001010000000101
101110101111111010111011101010101010111110101
101000100010001010001010001000101010100010001
101010111010111011101010111111101010101111101
101010100000100010101000100000101010000010001
101110101111101010101011101110101011111010111
100010101010001000101000100010101000001010001
111010101010111111101111101011101111101011111
100010101010001000100000101010001000001000001
101110101011101010111110101010101011111111101
100000101000100010001000101010101000000010101
111110101110111111101010111010111111111010101
100000100000100000100010100000100000001010001
101111111011101110101111101011101111101110111
101000001010001010100000001000101000000010001
111010111010111010111011111110101111111011101
100010001000100010101000100000101000100010101
101111101111101010101011101111101010101010101
100000101000101010101000100010000010101000101
111110101010101010101110111010111110101111101
100000101010001010100010100010100000101000001
101011101110111110111010101111101111101011111
101010000000000010001010100010001010001010001
111011111111111011101010101010101010111010101
100010000000101010101000101010101000100000101
101010111110101010101111111010101111111111101
101000100000100010100000001000101000001000001
101111101111111110101111101111101011101011111
100010101000000000101000100010101010001000101
111010101010101111111010101010101010111110101
101000100010100000100010001000101010000000001
101011111011111110101111111111101011111111111
101000001010000000100000000000101000100010001
101111101010111111111111111110101110101010101
100000001010000000000000000000100000001000101
111111111111111111111111111111111111111111111
