111111111111111111111111111111111111111111111
100000000000000000000000000000000000000000001
101111111011111011101010111010111011111011101
101000000000001000101010001010100010000000101
111011111110111110111110111110111111101110111
100010000000001000100000100000001000001000001
111111111011111110101010101111111010101111101
100000000000000010101010100000100010101000001
111111111111111011111111101010111011101110101
100000000000000000000000101010100000101000101
111110111011111111101110101111111110101111101
100000100000000000100010101000000000100010001
101110111010111011101010101011111010101010101
101000100010001000101010101010000010101010101
101010101011101110111110111110111111101010101
101010101000100010000010001000000010001010101
101010111011111110111111111111111011101110101
101010100000100000000000000000001000100010101
101110111010111010111010101110101110101010101
100010001010001010001010101000100010101010101
101010111010101011111111101111101111111010101
101010100010101010000000000000100000001010101
101011101010101110111011101111101111111010101
101010001010100010001000101000000000001010101
101011111010111010111111111011111011101110101
101000100010100010000010000010000010001000101
101110111111111010101111101011101111101110101
101000000000100010100000101000100010000010101
101011111010101010111111101110111011111110101
101000001010101010000000100010100010000000101
101111111111111111101111111011111111111011101
100010000000000000000010000010000000000010001
111011111111101011111110101011111110101111101
100000100000001000001000101000100000100000101
101111111110101111111011101111101010111110101
100000001000100000100010000000101010000010101
101111101010111011101110111110101110111010101
100000101010001010001000000010100010001010101
101110111110111110101111101111101111101110111
100010001000100000100010000010001000000010001
111111101110111110111111101010111111101010101
100000001000000010001000001010000010001010101
101011101111101110101011101110111110101111111
101000100010001000101010000010001000100000001
111111111111111111111111111111111111111111111
