111111111111111111111111111111111111111111111
100000001000100000100010000000100000100010001
101111101010101110101010111110101110101010101
101010000010100010001000100000101010001000101
101010111111111011111110111110101010111111101
101000100000000010000010000010100010100000001
101111101111111011101011111011101110111011111
100000001000001000001000001000001010001000101
101111111011101111111111111111111010101110101
101000000010101000000010000010001000100010001
101011111110101011111010101010101111111011111
101000101000100010001010101000100000000000001
101110101011111110101010111111111111111111101
100000100000000010100010001000000000100000101
101111101111111010111111101011111110111110101
101000001000100000100000001000001000100000101
111011111110111110101011111111101011101111101
100010000010001000101010000000101000101000101
101110111010101111101010111111101110101010101
100000100010101000101010000000001010001010101
111111101110111010101111111111111010111010101
100000101010001010100000000010000010000010001
111010101010101011111111101110111111111111111
100010100010100000000000100000000010000000001
101110111110111110111111101111111010111111101
101010100010100010001000101000100010100010101
101010101010101111101010101010101110101010101
101010101010101000100010100010100010001000101
101010101010101010101110111111111011111011101
101000101000101010001000100000000010001010001
101011101111101011111111111011111011101010111
101000100000001010001000100010001010001010001
101110111110111010111010101110111010101011101
101000100000100010000010100010000010101010001
101111101111101110111110111011111110111010111
100000001000001000100010001000001010000010001
111011111111101110101011101111101011101011101
100010001000101000101000101000001000001010101
101110101010101011101110101011101110111010101
101010100010000010001000101000100010100010001
101010111111111011101110101110111011101111101
100010100010000000100010101000100010001010001
111010101011111110111010111011101110111010111
100010001000000010000010000000100000100000001
111111111111111111111111111111111111111111111
