111111111111111111111111111111111111111111111
101010000010101010001010101000001000101010001
101011111010101011101010101110101110101011101
100010100010001000101000001000100010001000101
101110101111101011101011101111101010111010101
100000100010100010001010100000001000101010101
101010101010111011101110111111111110101011101
101010101010000010100010000010000000001000001
101011101111111010111010101111101110101111101
101010001000000010101000101000000010100000001
101110101011101110101011111011111010111111101
101010100000100010000000000010000010101000101
101010111110111011111011101111111011101110111
100000100010001000001010000010001000101000101
101111101110111110101010101110111011101011101
101010000010001010100010100000100000000010001
101011101111111010111111111111101110111111101
101010100000001010100000000010101010000010101
101010111011111010101111111110111010101010101
101000000010100010000010100010000000101010001
111110101010111010111110101110101110111110111
101010101010100000101000001000100010100000001
101011101010101110101011111111111110101110101
100000101000000010000010100010001000001010101
111010101111101011101010111010101111111011101
100010101010101010101010001010100000001010001
101011111010101010111010101010101110111011101
101000001000101000001010100000100010001010101
111011111011111111101111101110101010101010101
101010100000100000000010000010101010101010001
101010111110101111101110111110101111111010101
100010000010001010001000000010101010000000101
101110111010101010111111111010111011111110111
100010100000101010000000100010100000001010101
101011101011101011111011101110111110101010101
101010101010100010001010001010000010100000001
111010101110111010111110111011101110101110101
100000001000100000100000100000001000101000101
101111111110111011101110111110111011101111111
100000101010001000101010001010001000100000101
111011101010101110111011101010101110111011101
100000000000101000100000000010101010100010001
111011101110111110111111101110111010101110101
100000101000000010000000001000001000100000101
111111111111111111111111111111111111111111111
