111111111111111111111111111111111111111111111
100000000000000000000000000000000000000000001
111011101010111010111010101111101011101011101
100000101010100010001010101000001010001010001
111110111011111111101011101011101111101011101
100000001000001000001010001010000010001000101
111110101110111011111011101010111110111110101
100000101000100000100010001010000010100000101
101111111111111110101110111110101011101111111
100000000000000010101000100000101010000000001
101011101111101010111011111010111111111110111
101000100000101010001000100010000000000010001
101111101010101010111110111010101110111010101
100010001010101010000010100010101000100010101
111010101110101011101111101111101110101010111
100010101000101000100010000010000010101010001
101111111010111110111011101111111010101010111
101000000010000010100010000000001010101010001
111111111011111011101010101110101010101110101
100000000010000000101010100010101010101000101
111010111110101010111011111110111011111111101
100010001000101010001000000010001000000010001
101010101011101010101110111011101110111011101
101010101010001010101000001010000010001010001
111110111110111010111110111011111111101110111
100000001000001010100000100000000010001000001
111010101011101110101111101110111011101010101
100010101000101000100010000010001000101010101
101110101011111010111110111011101111101110101
101000101000001010100000100000100000101000101
101011111011101011111011111011101110111010101
101010000000101010000010000010000010100010101
101011101010111111101011111011101011101110101
101000101010100000001010000000101010000010101
101110101111111011101111111011111110111011101
100010100010000000101000000000001000001000101
101110101011101111101110101011101010111011101
100010101010000000101000101000101010001000101
101110111111111010101111111010111010111010101
101000000000100010101000000010100010100010101
111010101110101011101011111011101110111110101
100010101000101010001000100000100010100000101
101011111011101110111111101111111011111011101
101000001000100010000000100000100010000010001
111111111111111111111111111111111111111111111
