111111111111111111111111111111111111111111111
100000100000000000000000001010000000100010001
101111101111111111111111101010111111101010101
100010001000001000000000001000001000001010101
101010111011101011111111111111101011111010101
101000100010100010000000000000001000100010101
101111101110101111111111101111111010101110101
100000100010101000000010001000001010100000101
101110111010101010111010111011111010111111101
100010001010001010100010001000100010001000101
111011101011111010101111101110101111101011101
101000101000001010100000100010101000100010001
101110101111101110111110111010101011101110101
100000100000100010100010001010001000101000101
111111101111111010101111101011101010101010101
100000100000001000100010001000101010001010101
101011111111101011111010111110111011111010111
101000000000001010000010001000100010000010001
101111111111111010111011101011101110111111101
100000001000001010100010001000001000100000101
111111101010111010101110101111111011111010101
100000001010100010101000100010001000100010001
101110111010101110111011111010111110101111111
101000100010100010100010100010000000101000001
101011111010111010101110101111101111101011111
101010001010000010100000100010001000101010001
101010101011111110111111111010111010101010101
101000101010000000100000000010001010101000101
101111101110111111101011111111101010101111101
101000100010100010001000100010100010100000101
101010111010101010111010101010111110111011101
100010001010101010100010001010000010101000001
111111101010101010101111111011111010101110111
100010101010001010101010001010000010100010001
101010101011111010101010101010111110111011101
101000101010000010101000101000000010000010101
111011101010111110101011101111111011111010101
100010001000001000101000100000001010100010101
101110101111101010111110101111101010101110101
101000100000101010100000101000001000100000101
101011111111101011101011111011111111111111101
101000001000001000001010001000001000000000001
101111101011111111111110101110101011111111111
100000001000000000000000100010100000000000001
111111111111111111111111111111111111111111111
