111111111111111111111111111111111111111111111
100000101000000010000010000000000000000010101
101111101111111011101010101110101011101110101
100000101000000010001000101000101010000010101
101111101111101110111011111011111110111110101
100010001000001010001010101000000010100010101
101110101011111010111010101110111110111010101
100000101000000000001010101010100010100000101
111011101010101011101010101010101110111010101
100000101010101010001010000000001010000010101
101010101111101111101010101010101010111110101
101010100000000010001010101010100010000010101
111111111110111111111111111111111111111111101
100010001010001000100000101010100000101000101
111010101010101011111011101010101110101110101
100000100010101000000000100010101000101000101
111111111010111011101111101110101011101110101
100000000010000000100000000010001000000000101
101111111010111011111110111010101111111010101
100000101000001000101000101010100000001010101
101111101011101011101010101011111011111111101
101000101010001000100010100010000000000010001
101011101010111011111111111111101110111010101
100000001010001000000010000010000010100010101
111111111111101010111011111010101010111110101
100010001010001010001010000010101010000000101
101110111010111010111010111010111010111110101
100000000000001010001000100010001010000010101
111111111111101111111111111111111110111111101
101000001000100000101000101010000000000000101
101010101110101010101010101010111111111111101
100010101000101010000010000010101010100000101
111011111110111111101111111110101010111010101
100010001000100000101000001010000010101010101
101111101010111011101110101010111010101010101
100010100010100000100000100010001000000010101
111010101011111010101110101111101011111111101
100000001000100010101000100010001000100000101
111111111110111011111110101111101110101010101
101000100000000000100010100010001000101010101
101010101011111010101110111011101110111110101
100010001000100010100000100010001000000000101
111011101110111010111011111110111111101111101
100010001000100010000000000000001000000000101
111111111111111111111111111111111111111111111
