111111111111111111111111111111111111111111111
100010000000001000100000001010000000100000001
101010111110111010111010101010111110101111101
101000100010100010100010100010000010101000101
101111101010101110101110111110111110101110101
101000101010000010000010001000100000101000101
101010101111111011111011101011101110101011101
101010100010001000100010001000101000100010001
101010111011101110101110101110101011111010111
100010100000001000101000101000101000000010101
111110101111101111101111111011111111111110101
101000101000100010000010000000000000001000001
101011101010111011111010111111111111111011111
100010101010000010001010001000000000100010001
101110101011111110101011101011111110101110101
100010101010000010101010001010000000100000101
111010101010111010111010101011111111111011101
100010101010100010000010100010001000001000101
101110101010101111101110111110101011101110101
101010001010100000101000100010101000100010101
101011111010111110101111101110101110111010101
100010100010001000001000000000100010001010101
101010101111101111111011111111111011101011101
101010000000100010000010000000001000001010001
101011111110111010111111111011111111101010111
101010000000100010101000100000100000001010101
111010111110111110101010101110101110111010101
100010001010100010101010001000001010100010101
101111101010101010101011111111101010101110101
100000100010001010101010100000100010100000101
101110101111101110101010101110111110111110101
101000100000101000101010101010100010100010101
101111111110101011101010101010111010101011101
100000001000100010001000101010000010001000001
101011111011111110111011101011111111111110111
101000100010001000000010001000000000100000101
101110101111101111111110111110101010101111101
100010001000100010000010000010101010100010001
111011111010111010111111111010111011111010111
101010000010000010000010000010001000001010001
101011101111111010111010111111101111101011101
101000100000001010001000101000001000101000001
101110111111101011111110101010111110101111101
100000000000001000000000100010000000100000001
111111111111111111111111111111111111111111111
