111111111111111111111111111111111111111111111
100000000000000000000000000000000000000000001
101010111110111110101011111110101111111110111
101010000010100000101010000000101000000000001
101010101011111110111011101111101011101010101
101010101000000010100010000000101000101010101
111010101110101011111110111010111010101110111
100010101000101000001000001010100010100010001
101110111011111111111111101110101110111010111
101000100000000000000010000010101000001010001
101010101110101011111111101011101010101111101
101010101000101000000000101010001010101000001
111010101010111110101010111110111010111010101
100010101010000010101010100000001010100010101
101110101011111011111110101011101011101011111
101000101010000000000010101000101000101000001
111010111110111011101011111011101111101110101
100010100000001000101000001010001000000010101
101111111010111010101010111010101111101110101
100010000010001010101010001010100010000010101
101110111110111011111010101110111010111111101
100010100000001010000010101000001010000000101
111010101111111011111010111011111010111011101
100010100000100000100010100000001010001010001
111111101111101111101010111011101111111010101
100000000010000000101010100010000000100010101
101010101111111011111010111110111110111110111
101010100000001010000010001000100000000010001
111110111010111110111010101010101110101111101
100000100010100000001010101010101000101000001
101110101011101110101110101010101010111010101
101000101000100010100010101010101010100010101
101010111110111011101110111011111010111111101
101010100000100010000010100010000010100000001
101011111110101010101110101111111111111010101
101010000000101010101000100000000000001010101
111011101110101111111110101111101011111110101
100010001000100000100000100000101000000010101
101110101011101111101111111111111010101110101
100010101000100010000000000000100010100010101
101110111111101111111111111010101010101110101
100010100000000000001000000010101010100010101
101010111110111110101110101111101110101110101
101010000010100000100010100000100010100010101
111111111111111111111111111111111111111111111
