111111111111111111111111111111111111111111111
100000001000000000001000000010100000100000001
111111101111101111101111101010101110101111101
100000101000100010101000001000100010100010001
101011101010101010101011111011111011111010111
101000101010101010101000101010000000000010001
111010101010111010101110101010111111101111101
100010001010000010000000100010000000100010101
101111111011111111111111111111111110111010101
101000001000000010001000000010000000100010001
101011101110111110101011111010111010101111101
101010000010000010101000100010100010100010001
101010111011111010101110101011101011111010111
100010001000100010100000101000001010001010001
111111101110101110111111111111101110111011101
100000000010100010000010001000101000100010101
101111111011111011111010101010111010101110101
101000001000000010000010100010001010101000101
101011101111111110101110111111101110101011101
101010101000001000101000100000001000101000101
101010101011101111101110111111111011101010101
100010100000100010001000100000001000101010001
111110111110111010111010101111101010101011111
100010001000101010000010100000100010001000001
101010101110101011111110111110111111111011101
101000101000100000100010101000001000001010101
101111101011111110111010101011101011101010101
101000100010001010000000100010001000100010001
101010111110101011111111111010111111111111111
100010000010100010000000001010100010000000001
111111111010111010111111101010101010111011101
100000001000100010000010100010001010101000101
101111101111101011111010111110111111101111101
100000101000101010001000101000100010101000101
111110101010101010101110101011101010101010101
100010100010001010100010101010001000100010101
101010111111111110111011101010111110111011101
101010000010001000001010001000001010001010001
101111111010101011101010111111101011101010111
101000001000101000101000100010100010101010001
101011101111101111101111101010101010101011101
101000100000100000100000001000101010001010001
101110101111111010111111101111101011111010101
100000100000000010000000001000001000000000101
111111111111111111111111111111111111111111111
