111111111111111111111111111111111111111111111
100010001000000010101000101010000000001000101
101111101110111110101110101010111011111010101
100000100010100010100000100000100010000010001
111010101010101110111110101010111110111110101
100010001010001010001000001010100010100000101
101011101110111011101011111110111010111111101
101000100010000010000010100010100010000010001
111110101110111111111010101011101010101111111
100010101000001010100000001000001010100000001
111010111011111010101111101111111011101111101
101000000000100000001010001010001010000000101
101110101110101111111011101010101010101011111
100000101000001000001010000010101010101000001
101110111110111011101010111110111111101011111
101000001010001010000000000000000010001000001
101011101011111111101111111011101010101111101
101010000000101000100000100010001010100010101
111111111011101110111111111011101010111110111
100000101000000010001000101010001010000010001
111110101111111110111010101011111110101110111
100010100000100000001010100000000000101010001
101110101111111011101010101111101110111010111
100010001000100010000010000010101000000010001
111010111010101010111111111010111110101110101
100010000010101010001010001000000010100000101
101111101111101011111011101110111110111110111
100000000010001000000010000000000010100010001
111110111011111111111010111110111011101011111
100010100010100000000010100000100000101000101
111011111010101111101111111111111111111010101
101010000000101010001000000010000010000010001
101011111011111010111110111110111110111110101
100000100000000000000010000000001010000010101
101010101011111011101010101111101010101011101
101010001000101010001000100000100000101010001
111011111011101110111111101011101110111110111
100000100010001010101000001010001010001010001
111011111010101010101111101011111010111010111
100000100000100010101010101000001010000010101
101111101011101110101010101110111010111110101
101000001000101000101000000010001000100000001
111110111110101011101110101010111010111010101
100000000010101010000000101010001010001010101
111111111111111111111111111111111111111111111
