111111111111111111111111111111111111111111111
100010000000100000001010100000001000001000001
111011111011101111101010101011101011111011111
101000000000000010000000001010000000000000001
101110111010111011101111111010111010111010111
101000001010101000100000001010101010001010001
101110111110101011101010111110101111101110111
100000001000001010101010101010101000101000101
111010101110111110111111101010101011111110101
100010101000000000100010100000000000000010101
101011101110111011101110111011101110111111101
101000101000100000000000101010001010001000001
111011101111111010111111101111101010111010111
100010000010001010001010001010001000000010101
101111111011101110101011101011101110101111101
101000000000001000101000100000100010101010101
101110111110101111111011101111111110101010101
101000001000100000001000000000000010100000001
101110111110101110111110111011111011111011111
101000000010101000000000001000001000001000001
101110101111101010101010111110111111111111111
101010100010101010101010101010000000000000001
101010101010101111101011101010111011101111101
101000101010000010101000000010100010000010001
111011101110101010101010101110101111101111101
100000100010101000101010100010100000101010101
101011101010101111101110101111101010101010101
101000101010101000000010100000101010100010101
101011111011101010101111101110101011101010111
101000101000101010101010101010101010101000001
111011101011111011101010101010101010111110111
100000001000100010101000001010101010100010001
101010111011101010111011101010111110101111111
101010001000101000101000100010000000001000101
101011101111101111101011101011111110101110101
101010001000100010000000101000001010101000101
111011101011111010101011111010101011111110101
100000100000100010101000001010100000000000101
111011111110111011111010111011111011101011101
100000001000100000001010100000100000101000001
101010111111101110111110111110111010101011101
101010000010101000001000001010001010101010001
111110111110111110101110111010101110111110101
100000000000001000101000000010100010100000101
111111111111111111111111111111111111111111111
