111111111111111111111111111111111111111111111
101000100000000010001000000010001000000000001
101011101111111010101011111011101011101111101
101000001000000010101000101000101000101000101
101110101111111110111110101110101110111010111
100000100000000000000000100010000010100010001
111111111110111111111110111011111010101111101
100010001000100000000010100010100010101010001
101010101011111111111010101110101110101010111
101000100010000000001000100000100000001010001
101111111110101011111111111011111011111011101
101000000010101000001000100010000010001010001
101011111010111111101010101110111111101010111
101010001000100000101010000010100000100000001
101010101111101110101011111110101110111111111
100010100010100010101000100000101010100000001
111010111010111010101010101011101010101110101
100010001010001010101010001000001010100010101
101111111010111010101111111111111010111110101
100010000000101010101000000010100010100000101
111010111110101010101010111010101010101111101
101010100010100010100010001000001010001010001
101010101011111110111111101111111111111010111
101010001010000010001000001000001000000010001
101011111010111111101011111011101011111011101
101010000010001000100010000010001000001010001
101010111111101010111110111011101111101110111
100010000000000010100010001010001000001000101
101111111111111110101011111010111011111011101
100010000000100000101000001010000010001000001
101010111110101111111110101110111110101011101
101010100010100000100010101000001010101000101
101010101010111110101011101011101010111110101
101010101000100000101000100010000010000000101
111010101111101110101110111111111010111011101
100010100000100010101000100000000010100010001
101110111110111010101011101011111111101111111
101000100000100010101010001000100000100010001
101011101011101111101011101110101110111010101
100010001000100000001000001000100010001010101
111010111110111111111011111111111011101010101
100010101000001000101010001000001000100010101
101110101011111010101010101011101110111111101
100010001000000010001000100000100000000000001
111111111111111111111111111111111111111111111
