111111111111111111111111111111111111111111111
101000001000000010100010001010000000000000101
101011111110111110101110101011111010101110101
100000000000000010100000100000101010100010101
111110111011111110111110101010101011101111101
101000100010101000000010101010001010000000001
101111111010101010101111111011111011101110101
100000000000001010101010000000101000101000101
101011111010111010101011111011101011101010111
101000001010001010100010000000000000101010001
111010111110101111101010111111111111101011111
100010100000101000101000100000000010101010101
101110111110111010111010101011111010111010101
101000101000000010100010001000100010100000101
101111101111111011111111111110111110101011101
101000000010001000100010000000100000101000001
101011101110111010111011111010101111101111111
100010001010101010000000100010000010001010101
101010111010101010111110101111101111111010101
101010100000100010100000001000001000001000001
111011101110111011111110101110111110101011111
100000001010100010000000100010100000101000001
101111111011111110111110111110111111101110101
101000101000001010101010001000100000000000101
101011101010101010101010111110111110101110111
101010001010101000000010101010000000100010001
101011101110101111101111101011101110101010111
100000000010100000100010100010001000101010001
111111101111101110101110111011101010111110101
100000101000001010100000001010001010100010101
111010101111101010101111111011111111101010111
100010000010000010000000001010000010101000001
101111111010101111101111101010101110101111111
101010000010101000100000101000100000100000001
111011111011111110101011101011111111101111101
100000001000100010101000100010000000101000001
111110111111111010101110111010101010111011101
101000001000100000000010100000101010101000101
101110111011111011111110111110111111101110111
100010001000001010001000101010001000001010001
111011101110111011101110101010101010101010101
100000000010000010101000000010101010100000101
101111111110111110101010111111101110111110111
100000000000100000000010000010001000000010001
111111111111111111111111111111111111111111111
