111111111111111111111111111111111111111111111
100010000010000010100010000010000010000010001
111011111010111010101011101110101010101110111
100010000000100000101000100010101010101000101
111011111011111110111110101011111011101011101
100010100010000010000000001000000000101000001
101110111011111011111111111011111111101011111
100000100010000000000010101010001010000010001
101110111111111111101110101011101010101110111
101010001000001000000000101000100000101010101
111010111111101111101110101011101111111010101
100000100000100010101000001000001010001000001
111010111110111010111011101010101010111011101
101010001010101000100010100010100000000010001
101110111010101110111110111011111110111111111
101000001000001000101000100000101010101000101
101110111110111110101110111011101011101011101
100010100000001010000000000010001010101010101
101110101110111011101111111010111010101010101
100000000010000010000010000000000010100000001
111010111111101011101111111010101110111010111
100010101000001010001000101010101000000010101
111011101111111011111110101110111011101010101
100010000000000000000000000000000000101010001
111011111010101010101110101010111010111110101
100000101010101010100010101010100010001000101
101111101111101111101111111110111111101111101
101000000000001000000010001000000000100010001
101111111011111011101011101010111111101110101
101000100000100010001000100010000000100010101
111011111010111110111010101010101010101011101
100000000010001010100010101010101010101010101
101011101011111010101011101111111011111110101
101010101000100000101010001000000000100010001
111010111011101110111010111010101110101111101
100010100010101000100010100010101000001000001
111010111110111011101011111010101110101010111
100010101000000010001000101010100010101010001
101010101011101111101111101110111110111011101
101010000010000010000010000000101000001010001
111111101110101111101111111011101010101110101
100000000010100010000010000010000010101000101
111110101110101110111010111111101010111110101
100000100010100010100010001000001010000010101
111111111111111111111111111111111111111111111
