111111111111111111111111111111111111111111111
101010101010101000001000101000001000100010101
101010101010101010101110101011101010101010101
101010100010000010101000101000101010001010001
101010101110101011101011101111101011101110101
101000000000101010000000000000000010000000101
101111111111111111101111111111111111111111111
100000001000101010000000000010000010100010001
101011111010101010111011101111101010101010111
101000101010000000100010000010001010001000101
101011101011111110111110101110111010111010101
101000001000100000100010100010001000100010001
101111101110101110101011111011111111111111101
101000101000101000101010100010000010100010001
101011101011101011101110111011101110101011101
101000001000101000000010000010000010001010001
101011111111111111111111111010111111111010101
101000001000001000000000101010100010000000101
101111101110111011101011101010101110111111101
101000000000101000101000101010000000000010001
101011111010101011101110101010101111111011111
101000001010000000101000000000100010000010001
101011101011111110101111111011101110101111101
101010001000001000101000001010000010100000001
101011111110111011101010111011111110111111111
101010101010001000100010001010101000001000001
101010101010101110111011101010101010111110101
101000001000101000100010001010000010001000101
101111111111111011111111111111111011111011111
101000100010100000101000000010000000001000001
101010101010101110101010111111101110101011111
101010001010001000000010001010001000100000001
101111111010101010101110101011101110101110111
101010001010101010100010100010001000101000001
101010101010101111111011111011111111111011111
101000100010101000001010100010000010001000101
101111111010101010111010101010101110101110101
101000000000101010000010001010100000100000101
101111111111111111111111101111101111111110101
101010100010001000001000100010001010100000001
101010101010111011111110101110111010111110101
101000001000000000100000000010000010000010101
101010101110111010101011101111101010101110101
101010100010001010001000100010001010100000101
111111111111111111111111111111111111111111111
