111111111111111111111111111111111111111111111
100000001000001000001010101010101000101000001
111111101010111111101010101010101110101110111
101010000010100000000000101000001000001000001
101010111011111110101110101111101011111111101
101000001010101010101000000000100010001010001
101110111010101011111010101111111010111011101
100000101000000000101010100010000000100000001
101111101111101111101111101111111110101111101
101010000000101010100010000010000000000010101
111010111011101010101111101111111110111010111
101010100000000010000010000010100010001010001
101011111111101111101110101110101110111110111
101000000010100000101010101010100010001010001
101010111010101111101011101010101110111011101
100010101000101010101010000010100010100000101
101011101110101010101011101010101110111011101
101010000000000000101000101000001010101010101
101111111011101010101011111011111010101010101
101000101010101010000010001000100010001010001
101110101110111110111011101011111010111011101
101000000000000010100010000000100000100000001
111110111011101010111011101110101111111010101
100000100010001000100000001000000000000010101
111011101111101110111011101110111011101110111
100010000010000010100010000010001000100010001
111111111111111011111111101110111011111011111
100000000000000010000000001000100000001000001
111110111010101110111111101110111010111111101
100010100010101000101000100010100010000010001
111010101111111110101110101010111110111011111
100010100010001010100010001010100000001010001
111011111111101011101110101110111110111010101
100000000000001000000000100010000010001000101
111111101111101111101011111110111011111011101
100010000010000000001000100000001000001000101
111011101110101110101110111011111011111111101
100000000010101000101000001000101000000000101
101111101110111111101111101011101010111010101
100010001000100000100010001010000010001010101
101111101011101011101111101010111011111011101
101000001010001000100010101010100000001010101
101010111010111110101010101110111011101110111
101010100010001000001000101000001010000000001
111111111111111111111111111111111111111111111
