111111111111111111111111111111111111111111111
100000001000000000100010001000001000000010001
101111111010111011101011101010111011101011101
100000000010001010001000101010100010001000101
101111111111101110111110101010101110111110101
101000100000100000101000100010000010100000101
101010101110111111101011111111111010101111101
100010101000100000101000000010001010100000101
111110101011111010101111111010101010111110101
100000101000100010100000101000101010100010001
101111101110101110101110101111101110111011101
100010000010001010001000001000100010001000101
111011111011111010111111111010111010101110101
101010000010100000100000000010000010100010001
101010111110101111101111111111111111111011111
101000100010001010001000000000000000001000001
101111101110111010111010111111111111101011101
100000100010000010100010001000001000001010001
101011101011101110101111101011111011111010101
101010001000001000101000001000100010100010101
101010111111111011101011111110101110101110111
101010001000001010101000000010001010001010001
101111101010111110101111111010111010111011101
101000001010000000100000001010100000001010001
101011111011111011111011111010111111101010101
101000001000101010000010001010100000100010101
101111101110101010111110101010101110111010101
100010001010101000100000100010001000100010101
101110111010101111101111111111111011101110101
101000100000100010001000000000001010000010101
101011101111101010111111101111101011111010111
100010100010001010000000101000001000001010001
101110111011101011111110111011101111101111101
101000001000001000100010001000101000101000001
101011111111101111101011101010111010101011101
101000000000001000001010001010000010100010001
101111111111111011111010111011111110111110111
100000001000000010000010100010000010000010001
111111101011111110111110101110101111111011101
100000100010001000100000101000100000100000101
101110111110101011111110101110111110101110101
101010100010101000000010100010100000101000101
101010101010101111111010111011101110101111101
100010001000100000000000100000001000100000001
111111111111111111111111111111111111111111111
