111111111111111111111111111111111111111111111
101010000010100000100000100010000000101010001
101011111010111011111110101010111011101010111
100010001010000000101010001010100000101000001
111011101010111010101010111110101011101011101
100000001010101010001000100010101010101000101
111010111010101011111110101111111010101011111
101010100000001000000010100010001010100000101
101011111110111110111010111010111010111110101
100010000000101010001010001000000000100000001
101011111111101011111010111010111111111110101
101010000000000010100010100010000000101000101
101110111010101110111010111111101111101010101
101010001010100000000000000010000000100010101
101010111111101111111111111010101010111011111
100000101000100000001000101010101010001000001
101110101010101111111011101010111011111011111
101000001010100010001000100000100000001010001
111011111010111010101110101111111011111010111
100000100010001000100000101000101000100000001
111010111110111011101111101110101110101110111
100010100010001010100000101000000010101000001
101110111010111010101010111011111010101011111
100010101000101000101010000000001010001000101
101111101010101011101111101011111011111111101
100000001010000000100010101010001000100010001
111010111010111110111010101111101111101011101
101010101010000010100000100000000000001000101
101010101010111111111010101111101110101010101
101010100010001000000010101000000010101010001
101010101111111011111110111111101011101110111
101010101000100010100010001010001010001000001
101111101110111010101010111010111111111110101
100000001010001000101010000010100000001000101
101111101011101111111010111010111010111111111
101010001000100000100000001010101010000010001
101011111011101011111011111110101111101111101
100000001000101000000000101000001010100010001
101010111110101110111010101110111010101010111
101010100010001000001010001000000010001000001
101110101010111111101111101010101010101111101
100010101000000000100010001010101000101010001
111010111010101111111111101110101111101010101
100010100010100000001000000010100010001000101
111111111111111111111111111111111111111111111
