111111111111111111111111111111111111111111111
100000000000000000000000000000000000000000001
111111111111111111111110111111111111111111111
100000000000000000000000001010000000001000101
111111101111111111111111111010111011101110101
101000001000100010100000001000100010000000001
101010101010101110101011101111111111111111101
100010100010000010101000101000000000000000001
101011101011101110101110111111101111111111111
101000101000100000001000001000100010001000001
101111111111111111111111111011101011101111101
100000101010100010000010101000001010100000001
101111101010101110101010101011101110101010101
100010000010000010101000001000100000001010101
101110101011101110111010101110111111101111111
100000101010000010100010101010001010001010101
101111111111101011111110101011101010111010101
100000001010101010000000101000000010000000101
101011101010101011101111111011111111101110101
101010101010001000100000101000000010001000001
101110101010111110101010101011111111111111111
100010000000000010001010001000000000000000001
111111111111111010111111111111111111101111111
100000000000001010000000101000101010100010001
101010101010101010101010101011101010111010101
101010101010100010101010001000000000101000101
111111111011111110111111101110101110101010101
100000000000000010000010001000100010000010101
111111101111111111111111111110111111111111111
100010101000100000101010001000000010000000001
101010101011101010101010111111111011101111111
101000001000101010101010001010001010001000001
101011111011101011101010111010111011101111101
101000001000001000000010001000001010000000101
101111101110111111111010111110111011101010101
101000000000101010100010001000000010001010001
111110111110101010101010111011111110111111111
101000001000100000001000001010100010001010101
101011101011111011101111101010101110101010101
100000101000100010000010001000100010100000001
111111111111111111111111101011101010111110101
100000001010001010101010001000001010001000101
101110111010111010101011101110111011111110111
100010000000000000000000000000100000000000001
111111111111111111111111111111111111111111111
