111111111111111111111111111111111111111111111
100000100000100010101010001000001010100010001
101110111010101010101010111010101010101110101
101010100010001000100000001010101000000000101
101010111010111011111110111110101011111111111
100010000010101000100010000000101010100000001
111110111011101011101111101110111010111011111
101000100000101000100000001010100000001010101
101011111010101011111111101010101011101010101
101000100010100000101010001000001000100000101
101011111011111111101010101011101110111110101
100000100000100010100000101000101000100000101
101111101010101110111011111110111010101011101
100000101010000000000000001000001010101000001
111111111111111110111111111111111111111111111
101010000010100010001010101000001000101000101
101010111010111010111010101010101010101010101
100010100010000010001000000010101010000010101
111010111010111010111011101011101010111110101
100000100000100010000010001010000010000010001
101111111011111111111111111111101111111111101
100000101010001010000000000010000000000000101
101111101010111011111111101111111111101111101
100010100000000010101000101010100000000000101
101010111111101110101011101010111011111111101
101000100000000010000000001010100000101000101
111110111111111011101110111010111010101011101
100000100000000010001000001010101010101000101
111011111110111111101011101010101010101011101
100010100000000000001000101000100010000000101
101010111111101110111111111010111110111110101
101000100000001010101010101010000000001000101
111011101010101010101010101010111010101011101
100010101010100010000000000010100010101000101
101110111110111111101111111111111111111110101
100000100010000010000000000010001010000000101
101110101110101110111011101110101010111010101
100010100000100010100010000010100000100010101
101111111011111011101110101111111111101111101
101010100000100010100010100010001010000000101
101010111010111010111010111011101011101011101
100000100010100010101010100010000000101000101
111110101111111110101010111111101010101110101
100000100000000010000010000010001010001000101
111111111111111111111111111111111111111111111
