111111111111111111111111111111111111111111111
100000000000000000000000000000000000100010001
111110111111111111111111111111111111101010111
101010001010001010001010101010000000101000001
101011101010101010101010101011111011101011111
101000000000100010100000000010000000101000001
101011111111111111111110111110111111101111111
100000001000000000001010101010000000100010101
101110111011101011101010101010101010101010101
101010000010001010000000000010101010101000001
101011101011111110111111101010101110111110111
101010001010100010000000101010100010100000001
101011101010101010101110101010111110101110111
101000001000001010100010101010100000100010001
101110111110111011111111101111111110111010101
101000001000001010000000000010100000100010101
101110111010111011111110111110111010111011111
101000001010001010100010000010100010100010001
101111111111111110111010111110101110111011101
100000000000000010100010000010000010100000001
111110111111111110101111111011111011111011101
100000000010000010001000100010000000100010001
101110101011101010101010101111111011101010111
100010101000001010100010000000000000101010001
101110101111101010111011101110111111111111101
100010100010001010100010000010000000000000001
111111111111111111111111101111111111101110101
100000100000101000101010100000001010100010101
111011111010101110101010111010101010101111101
100010100010100000000000000010100000100010001
111010111110101111111011101111111111101111111
100010100010101010000000100000000000100000001
111010111010101011101110101111111111111110111
100000000000001010101010101000001000100000001
111110111111111010101010101010111010111111101
100000000000001000000010100010000010100000101
111110111110111010111110101111101110111010101
100010101000001010000010100010000010100010101
111010101010101011111111111110111111101110101
100010100010101000100010100000000000100010001
101110111011111010101010101011101110111111101
100000100000001010001000101010001000100010101
111011101011101110111111101110111110101010101
100000101010001000000000101000001000101000001
111111111111111111111111111111111111111111111
