111111111111111111111111111111111111111111111
101000000000001000100000000000001010000000001
101011111111101010111011111110101010111111101
100010000010001010100010000010100010001000101
101110111010111010101110111011111111101010101
100010101010000010000000001010000000001010101
111110101010111111111111111010111111111010101
100010001000100010000010001000100000101010001
101010111111111010101110101111101110101010111
101000000010000010100000100000100010101010001
101111111010111011101111111110111010101011101
100000100010100000100000100010100010101010101
111111101111101110111110101010101010101010101
101000100000000010100010101010101010001010001
101010101111111010101011101010101011111011111
100010100010100010001000001000101010000010001
111110111010101111111111111111101110111111101
100010000010100000100000001000001000000000101
101110111110111010101111101011111011101010101
100010000000101010100000100010001000101010001
111011111010101011101110101111101110101110111
100010001010001010001000100000001000100010001
101111101011111010111011111111111011111011101
100000101010000010001000001000001010000010101
111110101010111111111111101011101011111010101
100000001010001000000000101000101000001000101
101111111011101010111110101110101110101110111
100000100010000010100010100010100010100010001
101110101111101111101010111010111010111011101
101000101000101000001010000010001000001000101
101111101110111011111011111111101111111110101
100000100000100010000010001000001000001000101
111010111111101111101110101111111010101011101
101010001010001010001000100000000010100010001
101011101010101010111110111111111110111110111
100000100000100010100000100000000010001010001
101111111111111010101111101011101111101011101
101000100010001010001010001000100000001000101
101010111010101111111010111111111111111110101
100010001010100000001010000000000000001000001
111111101010111111101010111111111111101011111
100010001000000010000010100000100010001000001
101010111111111010111111101010101011111111101
101000100000000010000000001010001000000000001
111111111111111111111111111111111111111111111
