111111111111111111111111111111111111111111111
101000001000100000100010000000101000001000001
101011101110101110101110111010101010111011101
101010001000100010100010100010000010001000101
101011101110101010101010101010111010101110101
100010000000001010001000101010100010100000101
111111111111111111111111111110111111111111111
100000100000000000101000001010000010000000101
101111101111111110101010111011111011111110101
100000100000100000000010001010101010001000001
111011101011111011101011101010101011101011101
100010001000101000101010001000000010000010101
101010111011101011111111101011111010111010101
101000100000100000100010000010000010001000101
111011101010101110101010111010111111111110101
100000101010101000101000001010000010000000101
111111111111111011111111111111111010111111111
101000101010101000001010000010001010100000001
101010101010101110101010111010111010111110101
100010001000100000100010100010000010100000101
101111101011111110101010111111101010111011101
101000000000100000101000000010001010101000101
111111111110111110111011101010111110101011101
101010001000100000001010001010000010000000101
101011101011101010101111101111111011111110111
100010001000101010101000001010001010000000001
101111101010111011111011101011101010111111101
100000000010100000001010000010000010100000101
111111111110111111111111111011111010101110101
100000000000101000101000100010000010001000101
111111111011101110101010101111111011101110101
100000000000101000100010000010100010001000101
111111111011101011111011101110101010111010101
100000100010001000000000101010001010001010101
111010101110101011111010101011111011101111111
100010000000101000100010100010101010001000001
101011101110101111101111101110101010111011101
101010000010100000000000100010000010001000101
111111111011111111111111111111111111101011101
100000000000000000000000000000000010000000101
111011111111111111111111111111111110111111111
100000100010101000001010100000001000001000101
101011111010101011101010101111101011101010101
101000000000000000100000000010000010000010001
111111111111111111111111111111111111111111111
