111111111111111111111111111111111111111111111
100000100000000000100000001010101000100000101
101110101110101110111111101010101011101110101
101010101000100010000010000000001000000010001
101010111110111111101110111011111010111110111
100010100000000010101000001000000010101000101
111011111011111110101111101110111110101111101
100010000000000000100010100010001000000000001
111011111011111010111010101110111110101110101
100000001000101010100000100010100000101000101
111110111111101111111110111111101110111111101
100010001010000000001000000010101010001010001
111010101010111011111011101110111010111011101
101000100010001000000010100000000000000000101
101110101010111111111010101111111110111011111
101010101000001000100000100010001000101000001
101011111110111110101010101110101010101111101
100000100010101000001010100010101010100010001
101111101111101011101011111111101011101010101
101010001010000000101010000010000000001010101
101011101011111010101010101110101111101110111
100010000000100010101010101000101000101000001
101010111111111011111110111111111011111111101
101000001010001000000000001000100000100000001
101110111010111111111011111011111010111111111
101000000000100000100010000000000010100000001
101111111110101110111010101010101110101010111
101000000000001000000010101010100010001010101
111110111011111110111110111011111110111011101
100010101010001000001010001010100000001000101
111010101111101111111011111010111010111111101
100010001000001010100010100000001010100010101
101110111111101010101110101111111111101110101
101010101000000010000010000000100010000010001
101010101110111110111110111010111011111010101
100010100000001000100000001010000000000000101
101010111110111110101110101111101011111011101
101010000000100000100010100000101000001000101
101111111110101111111111111010101110111010101
100010001000000000000000000010101000001010101
101110111010111111111011111110101111111110111
100000000010000010001000100000100000001000001
101110111010101010111011111011111110101010101
100010001010101000001010000000100000101010101
111111111111111111111111111111111111111111111
