11111111111111111
10001010100000101
11101010111010101
10000000001010101
11111011101011101
10001010100000101
10101110111010101
10100010001010101
11111011101011101
10000000000000001
10101111111011111
10101000000000101
10111111111110101
10001000000000001
10111110101110101
10001000101000101
11111111111111111
