11111111111111111
10101000000010001
10101010111110101
10101010100000101
10101110111011111
10001010101000101
11101010101011101
10100000000000001
10111011111111111
10000000000000001
11101110111111111
10001000000010101
11101010111110101
10001010100010001
11111110111011101
10000000000000001
11111111111111111
