11111111111111111
10001000100000001
11101010101111101
10001010001000101
10111011111010101
10001010000010101
11101010111110101
10001000100010101
10101111101010111
10100000001010001
10111011111011101
10100000001000001
10101111101111101
10101000101000101
10101110111011101
10100000100000001
11111111111111111
