11111111111111111
10101000001010001
10101011101010101
10000010000000101
11111111111011111
10000010100000101
11111010111110101
10000010100000001
10101110101011101
10100010001000101
11111010101011101
10001010101000101
10101010111111111
10100010101000101
10111110101011101
10000000000000001
11111111111111111
