11111111111111111
10000000000000001
10101011101111101
10101010000000101
11101111111010101
10000010000010101
11101011101110101
10001000101000101
10111111101010101
10000000101010101
10111111111110101
10000010000000101
11101011101110101
10001010000010101
10111110101010101
10000010101010101
11111111111111111
