11111111111111111
10000010000000101
10111010111110101
10100000001000101
10101111101111101
10100010000000001
11111011111110111
10000010000010001
10111110111011101
10000010001000001
10101111111110111
10101000001000101
10111011101011101
10000010001010001
11111110101010101
10000000101000101
11111111111111111
