11111111111111111
10001000000000001
10101111101111101
10101000001000101
10101011111110101
10101000100000001
10111111101111111
10001000100010001
11101010111011101
10001010001000001
10111011101010111
10000010000010101
11111110111110101
10000000100010001
10111111111011101
10000000000010001
11111111111111111
