11111111111111111
10000000100010001
11101011111010111
10001010000010101
11111010111110101
10000010100000001
11101110101110111
10000000001000001
10101110111111101
10100010100000001
11101010111110101
10001010001010101
11101110111011101
10001000000000101
11101111101010101
10001000001010101
11111111111111111
