11111111111111111
10000000000000001
10111111111111111
10000000000000001
10101011101111101
10101010001000001
10111010111110111
10100010001000001
11111010101011101
10000010101010001
10101110111010101
10101000001010101
11101110101011101
10001000101000101
10111111101010101
10100000001010101
11111111111111111
