11111111111111111
10001010000000001
10101011101010111
10100010001010001
11101110101111101
10101000100010001
10101010101110101
10000010101000101
11111110111111101
10001000000000101
11101111101111111
10000000001010001
10111111101010101
10000010000000101
10111010111010111
10100010001010001
11111111111111111
