11111111111111111
10001010000000101
11101011111011101
10001000000010001
11101111111011101
10100000000000101
10101010111011101
10001010101000001
11111111101111101
10100000100010101
10111011111010101
10000000000000101
10101110111110101
10101000100000001
11111011111010101
10000010000010101
11111111111111111
