11111111111111111
10001000001000001
11101011101110101
10000000100010101
10101010101110111
10101010100010001
10101111111010111
10100000001000001
10101011101011111
10101010101010101
11101010111110101
10001000000010101
10111111101110101
10100000000000101
11101010111010101
10001010001010001
11111111111111111
