11111111111111111
10000000101010101
10101110101010101
10101000000010001
11111110111110101
10001000100010101
10111110101111101
10100000101010001
10111110101011101
10000010000000101
11111010111110101
10001010101010001
10111011101011101
10000000000000001
11101110111011101
10000010001010001
11111111111111111
