11111111111111111
10000000100000101
11101011111010101
10001010100010001
10111010111010101
10100000100010101
10101110111011111
10101010100000101
10101010101011101
10100010101000001
11101111111111101
10000010000000101
11101111111110101
10000000100000001
11101111101111111
10000000000000001
11111111111111111
