11111111111111111
10001000101010001
11101010101011101
10000010000010001
11111110111110111
10101000100010001
10101010111010111
10000010000010001
10111111111011101
10000000100010001
11111011111011101
10000000100010101
10111110101110101
10101000100010001
10101011111011101
10001000100000001
11111111111111111
