11111111111111111
10000010000000101
11111010111110101
10001010000010101
10101010111110101
10101010100000101
10101010101011101
10101000101000001
10101111101111111
10100010001000001
10111010101011101
10100000100010101
10101111101110101
10100010001000101
10111011111011101
10001000001000001
11111111111111111
