11111111111111111
10000000100000001
11101110101110101
10001000100010101
10111111111010111
10100000100010001
10101110111011101
10001010000010001
11101011111110101
10001000000000101
10111011111111101
10001000100010001
11101111111011111
10100000001000001
10111110101111101
10000000100000001
11111111111111111
