11111111111111111
10001000000000001
10101011111011111
10101010001000001
10111010111111101
10001010000000101
10101011111011101
10101000001000101
10101111101110101
10100000000000101
11111110111111101
10000010001000101
10111011101010101
10100010001010001
11101111111011101
10000000000010001
11111111111111111
