11111111111111111
10000000100010001
10101011101010101
10101000001000101
11111011111110101
10000000100010101
11111010101111111
10000010000010001
11111111111011101
10000010001000101
11101110101011101
10000000100000101
10111111101110101
10001000101010001
11101011101011101
10000000100010001
11111111111111111
