11111111111111111
10100000000010001
10101111111010101
10100010100010101
10111010101110101
10100000100010101
10111111111010101
10100000100000101
10101110101111101
10001010101000101
10101010101110101
10101000100000101
11101111111111101
10001000001000101
10111011101010101
10000000100010001
11111111111111111
