11111111111111111
10001010000000101
11101010111111101
10000010000010001
11111010111110101
10101000101010101
10101011101010111
10000000000000001
11101011101111101
10001010100010101
11101110101010111
10000000101010001
10101111111110111
10100000000000001
10111011101110101
10001010001000101
11111111111111111
