11111111111111111
10100010100010101
10111010111010101
10000010000000001
11111011111111101
10001010001000101
10101011101110101
10100000000000101
11101110111011101
10000010001000101
10111010111010101
10100010001010001
10101111111110111
10100010100000001
11111010101110101
10000010000010101
11111111111111111
