11111111111111111
10000000000000001
10111010111010101
10001010001010101
10111010101011101
10100010101010001
10111111111010101
10000000001010101
10111011101110111
10100000100010001
11101110101010111
10000010101010001
10101111111010111
10101000000010001
10101010111110101
10101010000010101
11111111111111111
