11111111111111111
10100000000000101
10101011111110101
10101010000000001
10101011111111101
10001010000000101
10111010111110101
10101010101000101
10101010101111101
10101010001000101
10101011101010101
10001010001010101
11111010111110101
10000010100000101
10111110101011101
10000000101000001
11111111111111111
