11111111111111111
10100000001000001
10111111101011111
10100000000010001
10111111101110111
10101000000010001
10101111101110111
10101000000000001
10101111111110111
10001010001010101
10111011101010101
10001010001000001
10111011101010101
10001000101010101
11101110101110111
10000000000000001
11111111111111111
