11111111111111111
10000010001000001
10101111101011101
10101000000010101
11101011101010101
10001010001010001
11101111111011101
10001010001000101
10111010111011111
10100000000010101
10111111111010101
10000000100000101
10111011101011101
10101010001010101
10101011101010101
10001000001000001
11111111111111111
