11111111111111111
10001000100010101
10111110101110101
10001010101010001
10111010101010111
10000000000010101
10111111101110101
10100000001000101
10101111101011101
10101000000000001
11111110101111101
10100010100000101
10111010101010101
10000000101010101
11111010111110111
10000010000010001
11111111111111111
