11111111111111111
10000000000000001
10101111101011111
10100010001000001
10101111101011101
10101000001010001
11111111111110101
10000000000000101
10111010111110111
10100010000010001
10111010111111111
10100010000000001
10111110101011111
10000010101000001
10111010111011101
10001010100000101
11111111111111111
