11111111111111111
10000000100000001
10111110101111101
10100010001000001
11101011111011101
10001000001000101
10111111101110101
10101000101000101
10101010101011101
10100010100010001
10111010111110111
10001010000010101
11101110101110101
10100010100010101
10111110111010101
10000000001000001
11111111111111111
