11111111111111111
10000000000000001
10111011101010101
10100000101010101
10101011101010111
10101010001010001
10101011111110101
10101000001000101
11101110101111101
10001000100010001
10111111101111111
10100000000000001
10101110111011111
10100010100000001
10111110111111101
10001000000000101
11111111111111111
