11111111111111111
10001000101000001
10111010101011111
10001010001010001
10101011111010101
10101010000010101
10101011101110101
10101000101000101
10101110101011101
10100010101000101
11101010101110101
10001010100000101
10111010111111101
10100010100000101
10111110101110101
10000000001000001
11111111111111111
