11111111111111111
10000000000010001
10111111111010101
10000000001010101
11101111101011101
10001010101000001
10111010101110111
10000000100010101
11111111111010101
10001000000010101
10111011111110101
10001000000010001
11101111111011101
10100000001010001
10111110101010111
10000000100010001
11111111111111111
