11111111111111111
10000000001010001
11101010101011101
10001010100010101
11111110111110101
10100000000010001
10111110111110101
10101000101000101
10101110101010101
10001010000010101
10111011101111111
10000010100010001
11101010101110111
10001000000000001
11111011111010111
10000000001010001
11111111111111111
