11111111111111111
10001010000000101
10101010111011101
10100010001010001
11101011101010101
10001010001000101
10111111101111111
10000000001000001
11101011101110111
10001010001000101
10111011101011101
10001010100000001
11111010101111111
10000010100010001
10111010101011101
10001010001000001
11111111111111111
