11111111111111111
10000000001010001
11101011111010111
10101010100000001
10101010101010111
10001000101010101
11111011101010101
10000000101010001
10111110101111101
10000010000000101
11101011111110111
10101000001000001
10101110111011111
10001000100000001
11101110111111111
10001000000000001
11111111111111111
