11111111111111111
10000000000000101
10111111111010101
10100000000010001
11101111111111111
10001000001000001
10111011101011111
10000010101010001
10111110101010101
10100000100010101
10101110111111101
10101000100000001
10101010111010101
10101010001010101
10111011101110101
10000010000000101
11111111111111111
