11111111111111111
10001000100000001
10101011101011101
10101000001000101
11101111101110111
10001010101000001
11101010101110111
10000000001000101
11111110111011101
10000000100000001
10111010111111101
10001010000010101
11111011101110111
10000010001000101
11111011101010101
10000010000010001
11111111111111111
