11111111111111111
10001010100010101
10111010111010101
10000000100000001
10111111111111101
10000010101000101
11101010101110101
10101010000000001
10111011111010101
10001000101010101
10101110101010111
10101000000010101
11101011101110101
10000000101010101
10111010101011101
10001010100000001
11111111111111111
