11111111111111111
10000000000000001
10101010111010111
10101010001010001
10101110101110101
10100010101000101
10111110101010101
10100000101010101
11101111101011111
10000000101000001
10101010111010101
10101010100010101
10111011101011101
10100000101000101
10111011101010101
10100000101010101
11111111111111111
