1111111
1010001
1011101
1000101
1010101
1010001
1111111
