1111111
1000001
1011101
1000101
1111101
1000001
1111111
