1111111
1000101
1010101
1010101
1011101
1000001
1111111
