1111111
1010001
1011101
1000001
1111101
1000001
1111111
