1111111
1000001
1110101
1000101
1011101
1010001
1111111
