1111111
1000001
1110111
1000101
1110101
1000001
1111111
