1111111
1010101
1010101
1000001
1110101
1000101
1111111
