1111111
1000001
1110101
1000101
1010111
1010001
1111111
