1111111
1000001
1110111
1010001
1010111
1000001
1111111
