1111111
1000101
1010101
1010001
1011111
1000001
1111111
