1111111
1000001
1110111
1000001
1010101
1010101
1111111
