1111111
1000001
1111101
1000101
1010101
1010001
1111111
