111111111
100000001
111011101
100010101
101110101
100000101
111111101
100000001
111111111
