111111111
100000101
111010101
100010001
101010101
101010101
101010101
101010101
111111111
