111111111
101000001
101011111
101000001
101111101
101000101
101011101
100000001
111111111
