111111111
100000001
111110111
100000001
101111101
101000001
111011101
100010001
111111111
