111111111
100000001
111011111
100000001
111110111
100010001
111010111
100000001
111111111
