111111111
100000101
101111101
101000001
101110101
100000101
111110101
100000101
111111111
