111111111
101010001
101010101
100010101
101111101
101000001
101110101
100000101
111111111
