111111111
100000001
111010101
100010101
101010111
101010001
101110101
100010101
111111111
