111111111
100000001
101110101
100010101
101110111
100010001
111011101
100010001
111111111
