111111111
101010001
101010111
101010101
101010101
101000001
101011111
100000001
111111111
