111111111
100000001
101111101
101000001
101111111
100000001
101111101
100010001
111111111
