111111111
100000001
101111101
100000101
101111101
100010001
101111101
101000001
111111111
