111111111
100000001
111011111
100010001
101010101
101010101
101010101
101000101
111111111
