111111111
101010101
101010101
100000001
101011101
101010001
101111111
100000001
111111111
