111111111
101000101
101010101
100010001
111011101
101010001
101110101
100000101
111111111
