111111111
100000001
111110101
100000101
101111101
101000101
101010101
101010001
111111111
