111111111
101010001
101011101
100010001
101110101
100010101
101110111
100000001
111111111
