111111111
100000001
111010111
100010001
101011101
101000101
101110111
101000001
111111111
