111111111
100000001
111110101
100000101
101111111
100010001
101010111
101000001
111111111
