111111111
100000101
111011101
100010001
111010111
100000001
101010111
101010001
111111111
