111111111
100000001
101110111
100010001
101110101
101000101
101010101
101010101
111111111
