111111111
100000001
101011111
101010001
101110101
101000101
101011111
100000001
111111111
