111111111
101000101
101110101
101000101
101011101
100010101
101110101
100000001
111111111
