111111111
101000001
101011101
100000101
101111101
101010001
101010111
100010001
111111111
