111111111
101000101
101110101
100000101
111110101
101000101
101011101
100000001
111111111
