111111111
100000001
101110101
101000101
111110101
100000101
101111101
101000001
111111111
