111111111
100000101
101010101
101010001
111111101
100000001
101111111
100000001
111111111
