111111111
101000101
101011101
100010001
101110111
101000001
101111101
100000001
111111111
