111111111
100010001
101011101
101010001
101111101
100000001
111110111
100000001
111111111
