111111111
100010001
111011101
101000001
101010111
100010001
101111111
100000001
111111111
