111111111
100000001
101110101
101000101
111110101
101000101
101011101
100010001
111111111
