111111111
100000001
101111101
101010001
101010111
101010101
101010101
100010001
111111111
