111111111
100010001
101111101
101000001
101110101
100000101
101011111
101000001
111111111
