111111111
100010001
101010101
101010101
101011101
101000101
101111101
100000001
111111111
