111111111
100010001
101010101
101000101
101111101
101000001
101110111
101000001
111111111
