111111111
100000001
101111111
101000001
101011101
101000101
101111101
100000001
111111111
