111111111
101000101
101010101
100010001
111011111
101010001
101010101
100000101
111111111
