111111111
100000001
101110101
100010101
111010111
100010001
101110111
100010001
111111111
