111111111
100010001
101010101
101010101
101010111
101010001
101111101
100000001
111111111
