111111111
101000001
101011101
100010001
101110111
100010101
111010101
100010001
111111111
