111111111111111111111111111111111111111
100000100000100010001000100000101010001
101110111010101111101110111011101011101
101000100010100000001000000000000010001
101111111011111011101011111011101110111
101010000010000010000010101000101010001
101010111011111011111010101010101010101
100010001010000010000010001010101010101
111011111010111111101110101111111010101
100000101000100010001000100000000010101
101110101111101111101110101010101110111
100010001000000000000010101010100010001
101011111111111110111111111010101110111
101000001000101000000010000010100010001
101011101010101110111110111111101010111
101010100010100010101000001000001000101
111110111110101110101110101110111111101
100000000010100000000000101010100010001
101111101110101111111110101010101111101
101010000000101000000000100010101010101
101010111110101111101110101010101010101
100010001010001000000010101010101000001
111110111011101011111011111111101110111
100000100000001010000000100010000000101
111110111111101111111111111010111110101
101000001000101000000000001000001000001
101011111110101111111110111011101111111
101010101010001010000000100000100000101
101010101011101010111011101011111111101
100000100010000010101000001000100010001
101111101110111011101110111011111011101
100000100000001000000000100010001000001
111111111111101111101010111010111110101
100010100010100000101010100000001000101
111010101010101011101110111111101111101
100000001000001000101000000010000010001
111011111110111111101110111110111010101
100000000010100000001000100000001000101
111111111111111111111111111111111111111
