111111111111111111111111111111111111111
100000000000000000000000000000000000001
111110111010111010101010111110101111101
100000100010001010101010000010100010001
101011111011101110101010101110111010101
101000100010000010101010101000001010101
111010111110111011101111111011101011101
100010001000001010000010000000101010001
101010111011101110111011111010101110111
101010100010000010100000100010100010001
101110101110111111101110101010101111111
101000101000000010000010101010100000001
111110101010111010101011111010111011101
100000101010100010101000100010001010001
101111111110111010101010101111101111101
100000100000001010101010101000001000001
101110101111101111111111111111101011111
101000101000000010000000000000001000001
101110111010101011101110101010101010101
101000100010101000100010101010101010101
101010101111101010111110101110111110101
101010101000001010000010100010001000101
101010111110101111101110101011101011111
101010001000100000100010101010001000001
101010111110111110101110101111111110111
101010000010000010101000101000000000001
111010101111101110111011101110101010111
100010101000000010001010001000101010001
111010111110111011111111101111101010101
100010001000001000000000100000101010101
101011101111101011111010101010111110111
101000101000001000100010101010100000001
101111101110101011101010101111111011101
100010000010101000101010101000000010001
101010111010101110111111111110111010111
101010100010101000000000100000001010001
111111101110111010111010101010111010111
100000000010100010001010101010100010001
111111111111111111111111111111111111111
