111111111111111111111111111111111111111
100000100000000000001000000000001000101
111110101111111111101011111111101010101
100010100010000000101000100010000010001
101010111010111110101110101011111111101
101000101010100000100000101000000010001
101110101010111111111111101111101011111
101000100010000000000010000000101000101
101110101111111011111010111110101110101
100010100000001010000010000010101000101
101011101111101010111110111110101110101
101000100010000010100010000010100010001
111110111011111110101011111010111010111
100010001010001000101000001010001010001
101011101010101111101111101111101111101
101000101010100000001000100000000010001
101110101010111111111010111111111010111
100010001010000000100010000000001010001
101011101011111110101111111111101111101
101000101000000010001000101000001000001
111111101111111011111010101011101011111
100000000000001010000010100010101010001
101110111011111010111010111110101010101
100010101000001000100010100010001000101
111010101111101111111110101110111111101
101010100010001000001000100000100010001
101010111010111010101010101111101010111
100010001010100010100010101000001010101
111110111010101011111110101011111010101
100010000010001000100000101000100000101
101010111111111110101111101111111111101
101010001000000000100000101000001000101
101111101011111111111111101111101010101
100000101000000000101000000000001010001
111110101111111010101011111011111011111
100000100000100010001000001000100000001
101011111110101111111011101110101111101
101000000000100000000010000010001000001
111111111111111111111111111111111111111
