111111111111111111111111111111111111111
101000100000100010100010001000000010001
101011101010101110101111101010111110101
100010001010000000001000000010000000101
101111111111111110101010111111101010111
100010101000000010101010100000101010001
101010101110111010111110111110101011101
101000000010100000001010001010001000101
111110101011101010111010101011101010111
100010101000001010001000100010001010101
111011111011111111101110101011111011101
100000000010000010001010101000100000001
111010111110111010111011101011111011101
100010100010101000000010001000100010101
111011101110101111111011101111101110101
100010000000100010000010001010101010101
101011101011101110111110101010111010101
101010001000100010101010101010000010001
111110111010101011101010111010111011101
101000001010001010001000101000100000101
101010101011111110101010101111101011101
100010101000001010100010101000001010001
111110111110101010101011101011111110111
100000101000100010101000100000100010001
101110101111111010111111101011101110111
100010100000100000001000001010000000101
101111101111111110111110111110111010101
101010000010100010101000001000100010001
111011111010111010101011101111101111111
100010000010100000000000101000001000101
101010111010111011111010101110101110101
101010001000101010000010101010100010001
111010111011101110101011111010111110101
100010100010000000101000101010001010101
111011101110111110101110101010111010101
100000000000000010100010001000000000101
101111101011101110111111101110111110101
101000001010000010000010001000000010101
111111111111111111111111111111111111111
