111111111111111111111111111111111111111
101000000000101000101000100010001010001
101010111011101110101010111011101010111
100010001010100000000010000010000000001
101111111010101111101011111111101011111
100000100000001000101010001010001000001
111011111110111010111110101010111111101
100010000010000010100010100010000000101
111110101110111110101110111111101110101
101000100010001010100010001000001000101
101010111111101010111011101110101010111
100010000000000010100000001010101010101
111111111010101111101111111011101111101
100010100010100010100000001000101000001
101010101010111110101111111011101110111
101000001010101000100000101000001000001
101110111111101110111011101011101110111
101010000000100000000010101010101000001
101010111011111110101010101010111111101
100010001000001010101000000000100000001
101110111011111010111110111111111011111
100010100010101000100000100000001010001
111111101010101011111110111011111011101
100010101010100000101010001000000000001
101110101110111011101010111011111011111
101010000000001010100010001010100010001
101011101111101110101111101010101110111
100000101010001000000000000000101010101
111110101011111011111111111110101010101
101010100010101000100000000010100000001
101010101010101110101111111010101111101
100010101000000000100010000010101000101
101110111010111011101110111111101110111
100010100010001000000010001010001000001
101110111011101110101110111010101110111
100000000000100010100010001000100000001
101110111110111010111111111011101010111
100010100000100010000000001000101010001
111111111111111111111111111111111111111
