111111111111111111111111111111111111111
100000000000000000000000100000001000001
101111111111111010111011101011101011101
100000000010001010001010001000101010101
111011111010111011101110111110101010101
100010001010001000100000100010100010101
101110101111101110111111111010111110101
100010100000001010000010000010001000101
101110111111111011111010111111101011101
101000100000100000001010000000101000101
101011101111101110111010111110101010101
101010000000100010001010001000101010001
101010111110111011101010111010101110111
101010100010001000101010100010100010001
111010101011101110101010101111111011111
100010101000100010101010100000001000001
101110101110111010101011111110101111101
100010101000100010100000000000100010001
111010111010101010111111111111111110101
100010000010101010000010000000000010101
101111111110101110111110111111111010101
100010000010100000100000100000000010101
111010101110111111101111101111111110101
101010100000100000100010001000000000101
101010111111101110101011101110111111101
101010001000001010101000100010000010101
101011111011111010111110111011111010101
101010000010000010100000101010000010101
101010111110101010101111101010111110101
101010100000101010001000001000101000001
101010101111101111111010111111101011111
101000101000100000000010100000001000001
101111101110111111111110101011111111101
100010001000001000000010001000000000101
101010111011101011111011111111111110101
101010001010101010001000100000001000101
101111101010101110101010111110101011101
100000000010000000100010000000101000001
111111111111111111111111111111111111111
