111111111111111111111111111111111111111
100010001000000000100010100000000000001
111011101011111111101010111011111011111
101000001000000010101000100010000010001
101111101110111110101111111111111011101
100000100010000010100010000010101010001
101110101010101110101111101010101011101
101000001010101010100000001000100010001
101110111010111010101110111111111011101
101000101000000000000010000000100000101
101110101111111110111011111010101110101
101010100010000010101000100010100010001
101010111010111010101011111111111010111
100010001000100000001010100000000010001
111111111010101011101110111111111011101
100000001010101010000000100000000010001
101111111111111010101111111111111011111
101000101000001010101000100000100000101
101110101111101010111110111110101011101
100000001000100010100000000010001000101
101111101110111011101110101110111110101
100000100010001000001000100010000010001
101011111110111010101010101111101110111
101000100000100010101010100010000010001
111010111011101010111111101111111110101
101010000010001010101000101010000000101
101011101010111111101011101010111111101
101000101000100000100000000010101000101
101010101111111011111011111110101110111
100010100000100010001000101010000000001
101110111110101010101110101010111110101
101000100000101010100000000000001000101
101011101011111010101011101110111010111
101010001010100000101010101010001010101
111011111110101110111110101010101111101
100000100000001000001000000010100000001
111011101010111010111111111110111010111
100010001010100010000000100000001010001
111111111111111111111111111111111111111
