111111111111111111111111111111111111111
100000000010001000100000100000001000001
111011101110101010101110101111101011101
100010101000100010101010100010001000101
101110101011111110101010101010111111101
100010101000000010100010001010000000001
111010101111111011111111111111111110111
100010001000101010001000000000000010101
101110111010101010101011111011111010101
100010100010001000100010001000100010001
101011101111111110111010111010111111101
101010001000000010100010001010000010001
101010111011111010111011101011111010111
101010000010000010001010000010001010001
101011111110111111101010111110101011101
101000000010100000001010100000101000101
101111111010101111111010111011101110101
101000000010100010001010000010001000101
101111101110111010101110111111111011101
101000100000001010101000100000101000101
101010111111101110101010101110101110101
101010101000100010101010100010100000101
101010101010111010101110111110111111101
101010101010001010100000000010001000101
101010101010111010111111111010101011101
101010000010001000000010000010101000001
101011111111101111111010111110101110111
101000001000100000100010000000100010001
101011111010111010111111111111111110101
101000001010001010000000001000100000101
101111101010111011111111101010111011101
101000001010100010000000101010001000101
101011111011101110111110101011101110101
100010001000100010000010001010001000101
111110101110111010111011111110101011111
100000100000100010101000000000100010001
101110111111101010101011111111111110101
100010000000001010001000000000000000101
111111111111111111111111111111111111111
