111111111111111111111111111111111111111
101010101000000010000000101000000000001
101010101111101010101110101111111110111
101000001000001010100010100000001000001
101111101111101010111110101111101110111
101010001010001000000010101010001000001
101010101010101011111010101010111111101
101000100000101010000010001000000010101
101111101110111011111011111011111010101
100000101000101010100000001010101000001
101010101010101010111010101010101011111
101010001010001010000010101000001000001
111111111111101111111111111111111111111
100000000010000010101000001000000000001
101110101011101010101011111111111011111
100010101010001000101010001000101000001
111111111010111110101010111010101010101
100000100010001000100000001010000010101
111011101011101111101111101110111110101
100010101010000010001000001000001000101
111010101111101010101010101010101011111
101010100010001000101010101010101000001
101010101111111010101110111111111011111
100000100010000010101000001000101000001
111110101111111110101111101010101011101
100000000000000000101000001010101000101
111111111111111111111110111010101110101
101000000000000000000000001010000000101
101011111111101011111011111011111011111
100000100010101010000000000010100010101
111011101110101011111110111010111010101
100000100010001010100010001010000000101
101111101110101010101011101010101111101
101000100000101010001010001010100000001
101110101111111010111110111111111111101
100000100000001010000000001010000000101
111011101010101010111010111010111010101
100000101010101010001010001000001010001
111111111111111111111111111111111111111
