111111111111111111111111111111111111111
100000001010101010101010000000100010001
111111101010101010101011111110111010101
100000101000001000100010001000100010101
101110101110111011111010111010101110111
101000001000001010100000001010000000001
101111111010111010111010101110111010111
100010000010001000100010100000100010001
101011101110111110101011111011111110111
101010101000001000101010000000100010101
101010101010101110101111101011101010101
101000001010100000000010001000101000001
111111111111111111111110111111111111111
101010101000001000000010100000100000001
101010101110101111101110101011111110111
100000100000101000001010001000100010001
101010101010101011101011111110101010101
101010001010101010001000001000101000101
111110111111111010111010101010101011111
101010000010001010000010100010001000001
101010101111101111111111111111111111101
101000100010001000000010101000000000001
101110101010101010111010101011111011111
100000101010100010100000101010101010101
101111111110111010111010101010101010101
100000000000001010100010101010100000001
101010111010111011111111101010111111101
101010100010001000000000100010101010101
101111111111111111101111101010101010101
101010000010001000001000101010100010001
101010101011101110101010101010101011101
100000101010001000100010101010001000001
101111111111101110111111111110111111111
100010101010001000001000100010000010101
101010101011101111101010101110111010101
101000001010101010001010100000100000001
101111101010101010101010101010101011101
100000100000001000100010001010101010001
111111111111111111111111111111111111111
