111111111111111111111111111111111111111
101010001010001010001000101010001000001
101010101010111011101010101011101110101
101000101000001010100010001010000000101
101011111010111010101011101011101111111
101000000010001010001000101010100000001
101110101010101011101010101010111010111
100000101010100000001010100010001010001
111011111111111011111111111110101010111
101000100010100000101000000010100010001
101010101010101110101011111111111111101
100010001010001000001010000010000000001
111110111111111110111010111011111011111
100010101010001010100000001010100010001
101010101010101010101111101010101110111
101010100010100000101000001000000010001
111010111010111111101011111010111010101
100000000010001000101000001010100000101
111011111110101110101011111110101011101
100010001010100000001000000010101010001
111010101011111011111111111011111110111
100000100010101000001000101010100010001
111010111010101010111010101010101011101
100010001010000010001010000010001000001
111111111111111111111111111111111111101
101010000000100010001010001000001000001
101011111110111010111010111011101011101
100010000010100000000010101000101010001
101110101010111111111010101111101010111
100010101000000000000010001000101010001
111010111010101111111010111010101011101
100010001010101010100010001010101010001
101111111011101010101110101011101010101
100000001000100010001010100000000010101
101110101110101110101011111011111110111
101010100000100010100000100010000010001
101010111011111110111110111010101110111
100010001000100000000010000000100010001
111111111111111111111111111111111111111
