111111111111111111111111111111111111111
100010000000000000001000001000000010001
101011111110101111101011101011111011101
101000000010101000100010100010001000001
101111111010101011111110111111101111101
101000101010101000000000000000000010001
101010101011101111111110111110111110111
100010100000100000001000101000100000101
111110111110111111101011101011101111101
100010001000000010001000100010001000001
101111101111111010111010111110111111101
101000001000101010100010100010000010001
101011111110101010111110101011111010101
101000100010100010100010101000001000101
101110101010101110101010101011111111101
100010001000101000101000101000000000101
111011111111101110101111101111111110101
100010000000100000100000100010000010001
101011111110111111101110111011111011111
101000000000100010001000001000000010001
101111111111101010111011101111111010111
101000100000001000001000100000100010001
101010101111111111111110111011101111101
101010001000001000100000101010001000001
101011111110101011101111101010111011101
100010000000101000100000100010100000101
101110111011101010111110111010111110101
100010101010101010000010001010001000101
111010101010101010111011101111101011101
100010101010001010101000100000101010001
101110101010111110101110111011101010111
101000001010100010100000101000001010101
101111111010101010101111101111111010101
100010001010001000100000100000001010101
111010101011111111111110111110101010101
101010101010001000000010100000101010101
101010101010111011101110101111101010101
100000100010000000100000001000000010001
111111111111111111111111111111111111111
