111111111111111111111111111111111111111
100000100000101000100000100000001000001
101110111010101010111011101011111110101
100010101010100010000010001000001000101
101110101110101011111110111110111110111
101000000000101010000010101000001000001
101111111011111010101110101011101110111
101010000010001000101010101010000000001
111011101110101110111010101111111110101
100000000000100000001010001000001000101
111011111011111010111011101010111111101
100010100010000010001000000010000000101
111110111010111111101011101011101011111
100010001010000000100010001010001010101
111010111011111111111010111111101110101
100000100000001000000010101000101010001
101110111011101110111111101010101010111
100010001000101010100010001010000000101
111011101011111011111011101011111110101
100000100000000000100010001000001000001
101110111010111110101110111110111011101
101000001010001000100000100010001010101
111010101011111111111011111011111110101
100010101010000000100000000010100010001
111111101011101111111110101010101111101
100010001010000000001010101010001010001
101110101110111011111010111011101011111
101000100000101000000010101000000010001
101011101110101110101111101011111110111
100000100010101000100000000000100000001
101111101111101111111011111110111010111
100010001000001000100000101010101010001
101111111110101011101110101010101010111
100010001010101000100010100000000010001
111011101010111011111111101110111110111
100000000000001000101000100010100000001
101011101110111010101010111011101111101
101000101000000010000010001000100010001
111111111111111111111111111111111111111
