111111111111111111111111111111111111111
100000000000000000000000000000000000001
111011111011111011101010101110111011111
100010000000001000101010101000100000001
101111101111111010101011101011111010101
101000000010000010101010001010000010101
101111111111111111111011101011101110111
101000000000000000000010001000101000001
111011111111111010111010101010101110101
100010000000000010001010101010100010101
111010111110101011101010101110101011101
100010001000101000101010100010101000101
101110111010101011111110101111101111101
100010001010101010000000101000000010001
101110111110111011101010111010101010111
100010000010100010001010100010101010001
101111111011101110101010101010101111101
100000100000101000101010101010100010001
111011111010111111101010111011111111111
100010000010001000001010001000000000001
101110111010111011111110101011101110101
101000100010100000001000101000101000101
101010101011101111101011111011101111101
101010101000100000101010000000100010001
111011111010111011101110101111111010101
100000001010100010001000100010000010101
101110101011111011101110111110111110111
100010101010000000101000100000100000001
101011101010101011111010101111111011101
101010001010101010000010100010000010001
111011111010111010101110111110101010111
100000100010001010100010001000101010001
101010101111111010101110101011111110111
101010100000001010101000101010000000001
101110101011111111101111101111111010111
101000101010000000000000101000000010001
101110111110101111101010101011111110101
100010100000100010001010101010000000101
111111111111111111111111111111111111111
