111111111111111111111111111111111111111
101010000000000010001000100000001000101
101011111110101010101011111111101010101
101000001010101010101000100000100010001
101111101010111010111110111010101110111
100000000010100000101000100010100010001
101111101111101110101110101011101110111
100010000000000010101000101010000010001
111011111011101111101011101110111011101
100010100000100000100000100000101000101
111010101111111010111011101010101010101
100010000010000010001000101010101010101
111110101010111111101011111010101011101
100010101010100000001000100010001000101
101011111010111011111011111011111011111
101000000010100000000000100000001010001
101111111010111011111110111010111010101
101010001010101010000000001010001000101
101010111110101110101011111010111011111
101000000000100010101010000010100010001
101111101011111011111010111011111110101
101000101000100000101000001010000000101
111110101011101111101011111111111111101
100010001000001000101000100000001000101
101111111111111011101011101111101110101
100000000010000010000000000000101000101
111111101110111010111110101111111110101
100000000010101000001000100000001000001
101011101110101110101110101010111111101
101010101000100000100010101010101010001
101110101011101111111010111111101010111
100010001010001000100010000000100000101
111110111111101010111110101111111011101
101000001000100010001010101010000010101
101110111110101110111011101011101010101
101010001000001000000010000000101000001
101010101111101011111010101110101111101
100000100000001010000010100010000000101
111111111111111111111111111111111111111
