111111111111111111111111111111111111111
100000000000000000000000000000000000001
101111101110101111111111111111101110101
100010001000100000100000000000001000101
101111111011101011101111101011111010101
100000100000101000101000001010000010101
101011101010101010101110111010111110111
101000101010101010101000001010100000001
101010111010101110111011101111101011101
101010001010100010100010000000101000101
111010111110111011101111101011101010111
100010100000001000100000101000101010001
101010101010111010111010101111101010111
101010101010100010100010100010001010001
101011101011101011101110101011101011101
101000101010001010000010101000101010001
101111101011111110111011111011101010101
100000101000001000100010000000101010101
101111101010111010101110111010101110101
100010001010100010100010001010101000101
101010111011101010101011101010111010111
101010001010001010101000101010100010001
101110101110111110101110101110101010101
101000100010100000101000101000101010101
101110111111111011101011111011101010101
101000100000000010001010000000101010101
101011111110111011101011101010111110111
101000000010100000101000101010100000001
101111101110101011101111111110101010101
101000000010101010000000100000101010101
111010111010101010101111101011101010101
100010001010101010100010001000101010101
111011111011101010101110101110101010111
100000001010001010101000100010101010001
111010111011101111101111111110111010101
100010001010000010001000000000100010101
101011111010111110101111101010101011101
101010000010000010100000101010101010001
111111111111111111111111111111111111111
