111111111111111111111111111111111111111
100000000000000000000000000000000000001
111110111011111010111010101110111110111
100000100000100010001010101000000010001
101010111111101110101010101010111111101
101010000000101000101010101010000010001
111011111011101010111111101010111111101
100000001010001010001000001010000010001
111110111110111110111011111010111011101
100000001000001000001000001010100000101
101110101111111010101011111011111110101
100010101000000010101000100000000010101
111111101110111110111011111110111110101
100000001000000010001000000010000010101
101111111011111111101011111011101111101
101000000000000010001000001010000000101
111110111110111010111111101011101111101
100000000010001010000000101010000000101
111011111010111011111111101011111011111
100000001010100000001000001000001000001
101110111110111111111111111110111010101
100010001000000000000010000000100010101
101011111011101110111111111111101111101
101000001000101000100000000000001000001
101111101010101110111010111011111011111
101000001010100010001010001000100000001
111110111010101011101011101010101010101
100000001010101000101000101010101010101
101011101111101110101010101111101110111
101010001000001000101010101000001000001
101110111011111010101111101110111010101
100010100000001010100010001000001010101
101110111111111010101110111110111010101
100010000000100010100010100000100010101
101011111111101011111010111010101110111
101010000000001010000010100010101000001
101011111111101011101111111010101010101
101010000000001000100000001010101010101
111111111111111111111111111111111111111
