111111111111111111111111111111111111111
100010000000001000000000000010000000101
101111111111101111111111111011101110101
101000101000000000100000000000101000101
101110101111111010111010111011111110101
100010001000001010000010101000001000001
101110111010111110101111101111101011111
100010101010000000101000100010101000101
101010101010101011101010101110111010101
101000101010101000100010000010001010001
101010101111111110111110101110101110111
101010000000000000100010100000101000001
111111111011111111111010111110101011101
101000100000001010001000000010101010001
101011111011101011101110111111101110101
100000000000101000100010000010000000101
111011101011101110101110101111111010111
100000101010101000100000101000100010001
101011111010111110101011101110111010111
101010100000001010101010001000001010001
111110111110111010101011111010111111101
101010001000100000001010101010001000101
101011101011111110111110101010101011111
100000000010100000001000101010101000001
101011111010111110101011101110111011101
101000101000100010100000100000100010001
111010101011101111111111101011111010111
101010101000100000100010101000000010001
101111101011101110111010101111101010111
100010000000001010101000100010101010001
111011101111111010101110111010111110101
100000001000101010101000000010101010101
101110101011101011101110111010101010101
101010100010001000101010100000100000101
101010101010101010101010101111101110111
100010101000101010000010101000001000001
101010101011101111111010111110111011101
101010101010000000000000000010100010001
111111111111111111111111111111111111111
