111111111111111111111111111111111111111
101000000000000000101000001000001000101
101011111010101011101011101111101110101
100000100010101000101010001000001000001
101010101110101110101010101011101111101
101010100010101000000010101000100000001
111110101110101111111011111010101111101
100000100010101000000000001010101000001
111011111111101110101110101110111111111
100000000000101000101000100000101000101
111010101010101110111011101010101010101
100010101010101000001010101010000010001
101110101111101111101010101111111011111
100010101000101000001000101000000000001
111110101010111111111111111111111111101
100000100010100000000000000010000010001
111110111111111011111111111110101010101
100010100000100000000010000010101000101
101110101110111011111110111111101011111
100000000010100010001010100010001000001
101110111010101010101010101010111011101
100010100010101000100000001010101010101
101111111111101111111011101110101010101
101000001000101010001010100010001000101
101111101011101010111010101110111110111
101000100000101000001010101010001000001
101011101011101111101010101010111010101
100000001000100000001010000000001010101
101110111110111111111011111011101011111
101000001000100000000010000010001000001
111111111011111110111111111111111111111
100000000010100010100010101010000000101
101010101010111010101010101010111010101
101010101000100000001000000000100010001
111011111111111111111111111111111111111
101010000000000010100000101010000000101
101010101010101010101010101011101011101
100000101010101000001010000000001000001
111111111111111111111111111111111111111
