111111111111111111111111111111111111111
101000100000001010001010100000001010001
101010101010111011101010111011111011101
101010001010000010100010000000100000101
101110111110111110101111111011111110101
101000101000000010001010100000100010001
101111101110111110111010111011101110111
100000100010100010101000100000101010001
111010111010101110101011101111101010111
100010001010001000000000100000101010001
111111101010111110111111101111101010111
100010101000000010001000001010000000001
101110101010111010111110111010101110111
101010100010100000001000001000100010101
101010101110111011111011111011111111101
100000001000100000000000000000001000001
101111101111111010111011111110111010101
101000000010000010001000101000000010101
111111101111101011101111101111111111111
100000000010001000100000000000000010001
111111101111111010111011111110101110111
101000000010000010100000000010101010001
101011101111111011111011101110111010101
100010000000001000100010100010000000101
101110111010101011101010111011111011101
101010100010101000101000101000101000101
101010111010111110111011101011101010101
100010100010000010100000001000100010101
101111101110101111101011101111111011111
100010001000100010001010100000100000001
101110111110111111101010111111101111111
100010100000000010001000000000100000001
111111101110111110111010101110101011101
101000001000100000100010100010101000101
101010111110111110111011101111111110101
100010100010000010101010100000000010101
101010101110111010101010111011101010111
101010000010100010001000001000101010001
111111111111111111111111111111111111111
