111111111111111111111111111111111111111
100000001000000000100010001000100010001
101111101011101011101011101010111010101
101000101000101010001000000010000010101
101011101110101110111110111111101111101
100000101000100000100010100010100000001
111110101011111111101011101010111011111
100010101010000010001000001010001000001
101110101011101010111011111011101111101
101000100010001000100010000010001000101
101011101110111111111010111110101011101
101000100010100010000010100010101000101
101110101010111010111110101010111110101
100010101000100010001010101010100010001
111010111111101011101010101010101010111
101010001000001010001010001000101010001
101011101011111010111010101111101011101
100010001010001010101010101000001000001
111011101010101110101010101011111111111
100010001010100000101010101010000000001
101110111010111111101010111011111011101
101000100010000010101000001000001010001
101011111011111010101011101111101010111
101010000010000010100010101000101010101
101010111110111110111110101110101010101
100010001010001010001000101000100010001
101111101010101010101010101011111111101
101000000010101000101010001000100000101
101011111110101110101011111110111011101
101000001000101000100010001000000010001
101111101111101011111110101011111010111
100010101000001010000010100000001010001
111010101010111010111010111111101011101
100010001010001000101010000010101000101
101110111011101111101011111010101111101
101010001000101000001000000010000010001
101011101110101011101111111110111110111
100000100000101000100000000000100000001
111111111111111111111111111111111111111
