111111111111111111111111111111111111111
100000101000100000001010001010101010001
111110101011101011111011101010101010101
101010101000001000001000000000000010101
101010101010101110111011101111101111101
100000101010101000100010000010101010001
101011101011101010101010111010101010111
101000000000101010001010001010000010101
111111111111111111101111111111111110101
101010000000000000100010100000000010001
101011111010111010101010111011111010111
100000001010001010101010000010001010001
111010111011101110101011101110101010111
100010001010000010101010000010100000001
111010111011111110101010101010101110111
100010000010000000101000101010100010001
111111111110111111111111111011111111101
101010100000100000100000100000000010001
101010101011101010101110101111111011101
100000001000101010101000001000000010001
111111111110111110111110101110111011101
100010100000100000100000101000100010001
101110111010101111101010101110101011101
100010100010100000101010101000101010001
111010111011101111111110111111111110101
100010101000001000000010001000101010101
111010101110101011101111101010101011101
100000000000100000100000000010001010001
111111111011101111111111111110111010111
100000000000100000100010000000001010101
111011111111111111111011111110111010101
100000001000100000100010000010101010001
101110111010111110101110111010101011101
101010000010000010100010001000000010001
101010101010101110111010101110101010111
101000101010100000100010101000101010001
111111111111111110111011101011101011101
100000000000000000100000001000101010001
111111111111111111111111111111111111111
