111111111111111111111111111111111111111
100000000000000000000000000000000000001
111010101110101111111111111011101111101
100010101000100000000000001000101000001
101010111010111010111110111111101110101
101010100010100010100000100000001000101
101111111111111011101111101110111111101
100000000000001000100000101000000010001
101110101111111011111011111010111111101
100010101000000000100000001010000000101
101110111111111011101110111010101011101
100010000000001000101000001010101010001
101011101011101010111011101110111011111
101000101010001010001010000010001000001
101111101111111110111011111010101110111
101000000010000000001010000010100010001
101011111111101110111010101110111010101
101000001000000010001010100010001010101
101010111111111110111011101010101010101
101010000000001000001010001010101010101
101111101010111010101011111011101010111
101000001010100010101010000000101010001
101011101110101011111011101010111110101
101000100010101000100000101010000010101
101010101110101111111111111010101110101
101010101000100000000000100010100010101
101110101011101010101010111011111111101
100010101000101010101010100000000000101
101011101111111010111010111111101110101
101000100000100010001010000000100010101
101010111010101010111110101110101010111
101010001010101010001000101000101010001
101011101011101010111010101110111011101
101000101010001010100010101000100010001
111011101111101110111011111111101110111
100000100010001000001000000010001000001
111010111110101011101010101011101111101
100010000010101010001010101010001000001
111111111111111111111111111111111111111
