111111111111111111111111111111111111111
100010101010001000100000100000000010101
101110101010111010111011101011101010101
100010000000001010101000001000101000001
101111101110111110101011111011111011111
100000101010001000100000100000001010001
111010101011101010101111111010101011101
100010000010101010100000100010101000001
111011101010101110101111111111111111101
100010001010000000100000101010000000001
111011111110111110111110101011111111101
100010000000001000100010100010101000001
111111111111111110101010101110101010111
100010001000000000101000100010100010001
111010111011101110111110101110101110101
100010000010001010100000101010101010101
111010101010101010101110101010101010111
100000101010100010100010100000000010001
101111111011111010111110111111111111111
100010000010000010100000001000001010001
101111101110101010101011111110111010111
100010000010101010101000100010001000101
111111111111101111101010101010101010101
100000000000000000001010001000100010001
111111111111111111111111111110111111111
101000001010001010001010001000100000001
101011101010111011101011101110101111101
100000101010001010101000001000000010001
111011111010111010101011111011101110111
100000101000000010001000001000100010001
101110101011101011101011111110111011111
101000000010001010001000001000100000101
101111111010111010111010111110101011101
100000001010001010000010000000101000001
111011111111111011111110111111101111111
101000101000001000001000001000000000001
101110101011101011101110101111111011111
100000000010001010000000101000000000001
111111111111111111111111111111111111111
