111111111111111111111111111111111111111
100000001010001000000010001000000000001
111011111011101010111010101111101011101
100000101010000010100010100000001010001
101110101011101110111011101010111010111
101000101010001000100010001010001010001
111011101010101011111011111011111111111
100010001010101000100010000000100000101
101010101011111110111111111011101010101
101000101010001000100010000000101010101
111011111010101110101010111010101011101
101000000000100000001010001010001000101
101011101111101111111110111111101111101
100000101000000000000010001000100000101
101111111111111111111111101110101111101
100000001000000010000010000000100000101
111110101010111010111111111011101010101
101000100010001010000010101000101010001
101010111110111110111110101010111011101
100010100010001000000010000010100000101
101111101111101010101111111111111011111
100010100010000010100010001000100000001
111010111010111111101111101110111110111
100000100010100010000010001000101000101
101110101110101011111010111110101110101
100010100010001010100010000000000000101
101111101111111010101011101111101110101
100000100000000010001010000010101000001
101011111011111111111110111010111111101
101000101000000000001000100000100010001
101011101010101010101010101010101010111
101000100010101010100010101010101000001
101111111111111111111110111110101010111
101000100010100000100010100000101010001
101011111010111010111011111111111110111
100000000000101010000010000010101000001
101110111010101010111011101010101010111
101000100010000010100010001000000010001
111111111111111111111111111111111111111
