111111111111111111111111111111111111111
100000000000000000000000000000000000001
111110111011101011101110101111111110101
100000001010001000101000101000000000101
101111111010111110111111111010111110111
100000100010001000000000100010100000001
101011101011111110101010111111101010111
101000101000100000101010100000001010001
111110111111111010101110111011111010101
100000000000001010100010001000001010101
101011101110101011101110101111111111111
101010000010101010001000100000000000001
111110101011101110111110101011101011101
100000101010001000000010101000101000101
101010101110111111101011101010111110111
101010101000100000001000101010100000001
101111101011111010111111111010101111101
101000001000001010000000100010101000001
101110111010101010101110111111101010111
101000100010101010101000000010001010001
101011101110101110101010111011101110101
101010001000101000101010100000100010101
111011101011101111101111111110101110101
100010001010001000000010000000101000101
101010101010111110101111101111111111111
101010101010100000101000000000000000001
101110111110101111111110111010101110101
100010100000100000100000100010101000101
101011111110111010101011101011111110101
101000001000100010101000101010000000101
111011101011101111101010111010111110101
100000101000100000101010001010100000101
111010111010111011101011111010101011111
100010001010100010001010000010101000001
111111101110101011101011101111101010101
100000001000101010001010001000001010101
101111111011111011111110111010101111101
100000100010000000001000100010101000001
111111111111111111111111111111111111111
