111111111111111111111111111111111111111
101000101000100010000000100000101000001
101011101110111011101110111010101011111
101000101000000000100010101010100010101
101011101111111011101111101110111010101
100010001000000000001000100010000000001
101110111111101111101011111010111011101
101000001000000010101010100000001010001
101111101010111110111010111010111111101
101010001010001000000000001010001000101
101010111110111011111110111011111110111
100010100000101010001010000010001000001
111010111110101110111011111010111011101
100000101010000010101010100000001000101
111110101011101110101010101011111011111
100000001010100000101000001000000000001
111111101010111011101010101110101111111
101000000000000000001010101010100000001
101110101010101010111011111010111010111
101010101010101010000000000010100010101
101010111110111110101111111111111011101
100000101000100000101010000000001000001
111110101110111110101010101110101010101
100000100000101000100000100010101010101
101011101110101011101010111111111010101
101010001010100000101010000000100010101
101110101010101110101011101110111111101
101000101000101010101000101000000010001
111111111010101010111011111110101010101
100000001010100010100000101000101010101
111110111110111111111010101011101111101
100000001010000000100010001000101000101
111010111010101011111010111110101011111
100010000000101000001010000010100000001
111111111010101111111011111110101110101
101010001010100010000010001000100010101
101010101010101010111010111110111010101
100000100010101010100000000010100010101
111111111111111111111111111111111111111
