111111111111111111111111111111111111111
100010101000100010101010000000001000001
111010101010111010101010111010111111101
100000000010100010000010001010001000001
101110111010101110111011101010111110101
100010001010000000001000001010001010101
101111111011111111111111111111111010101
101010000010000000001010001010101000101
101010111110111110101010111010101111101
100010001000001000100000001000001000101
101111101011101011101010101010111010101
100010001010001000101010100010001010001
111011101011111111111111111111101011111
101010000010000000000010001000101000001
101011101111111111101110101010101110111
100010100010000010100010100010100010101
111010101010111010101010111111101010101
100010001010100010001010101010101000001
101111111010101110111110101010101011111
101010001010100000000010000000101000001
101011101011101111111110111010101011111
100010000010100000000000001010101010101
111011101110111111111011111011101010101
100010001010100000100010000000001000001
101110101010111011101111111110101011111
100010100010101010000010001000101000001
101111101110101010101010111110101111101
100010001010100000101010001000101010101
101110101010111011111010101010101010101
100010100010000000100010100010101000001
111111111111111111101111111111111111111
101000100010101010001000000000001010101
101110101010101010101011111010101010101
101000001000100010100010001010100000001
101010101111101010101011101010111011101
101010100000001010101010001010100000101
101011101111101010101010101010111010101
100000100000101000101000101010100010101
111111111111111111111111111111111111111
