111111111111111111111111111111111111111
100000000000000000000000000000000000001
101111111110111010101011111010101110101
100010000000001010101000100010101000101
101110111111101011101110101010101011111
101000100000001010000010101010101000001
101010101011111110111010101111101110101
101010101000001000100010101000000010101
101111101111101011111011101011101110101
100000100000101010000000101010000010101
101110101111101010101011101011101011101
100010100000101010101010001000101010001
111111101110111011101110111110101011111
100000001000100000101000001000101000001
101110101110101011101110101010111110111
100010101000101000101000101010100000001
111111101110111011101010111110111011101
100000000010100000101010000010001010001
111110101011101011111111101010111110111
100000101000101010000000001010000010001
101010111110101010111010111110101010111
101010000010101010001010100000101010001
111111101011111110111111101110111010111
100000001010000000000000100010100010001
111010111010111010101011101010111010111
100010001010100010101010001010100010001
101010101111111110101010111010101010111
101010100000000010101010001010101010001
101010101010111010111110111111111011111
101010101010001010001000000000001000001
101010111111111010111010101111101011101
101010000010000010001010101000001000101
101110111111111111101110111111101110101
100010000000000000100010000010001000101
101110111010111011111110111011101111101
100010100010100000000010100010000000101
101010111110111010101110111010111010101
101010100000100010101000100010100010101
111111111111111111111111111111111111111
