111111111111111111111111111111111111111
101000000010000000100000001000000000001
101011111010111110101110101010111111101
101000001000100000101000101010001000001
101111101111101111111010111011101111111
100010001010001000001010001000100000001
101110101010111011101011101110111111101
100000100010100010001000100010100010001
111111111010101110111111101010101010111
100000001010101000001000001010001010001
101111101110101111101011111011111011101
100000100010100000101010001010100010101
111111111010101110101010111010101110101
100010001000100010101000100010001010101
101010101010111110111110101110101010101
101000100010100010000000101000101000101
111111101111101010111111101011101110101
100000000000101000100000101000100010101
101111111110101111101110101111111010101
101000001000100010000010100000001010001
101011111011111010111010111111101010111
100010001000001010100010100010000010001
111010101111111010101111101011111111101
100000101000001000101000001010001010001
101111111011101111101011111010101010101
101000000000100000000010001010101000101
101111111111111111111110101010101111101
100000101000100000100010101000100010001
101110101010101110101110101111111010111
100010000010001010000000101000000010101
111011111111111011111011101111111010101
101010000000001000001010001000000010101
101010111111101011101110111011111110101
101010000010101000101000100010001000001
101011111010101111101011101111101011111
101000001000100000001010000010000010001
101111101110111111111011111010111110101
100000000010000000000000000010000000101
111111111111111111111111111111111111111
