111111111111111111111111111111111111111
100000001000001000000000000000001000001
101111101011101011111111101111101111101
101000001010101010000000100010000000001
101011111010101011111010111010111111111
101000000010101000000010100010001000001
101111111110111111111110101011111011101
100000000010000000001000101010001010001
111111111011101111101011101110101010101
100010001000001000001010001000100010101
101011101111111011111010111011111110111
101000001000001000001010000000000010001
101111101011111111101011111111111111101
100010100010001000001010001010000000001
111010101110101011111010101010111111101
100010001000100010001010100010001000101
101111111011111110111010111011101011101
101000001000100010000000101010001000001
101011101110101011111111101010111011111
100010000010001000001010000010001010001
101110111011111111101010111111101011101
100010100010000000101000001000101000001
111010101110111011101111101010101111101
101010100010101000001000101010001010001
101010111110101111111010111011111010111
100010000010100000000010000010000010001
111111111010111111101111111111101011101
100000000010000000001010001000001000101
101011111111111111111010101010111111101
101010001000000000001000100010000000101
101110101010101111111011111111111110101
101000100010101000000010000000000010001
101011111110101011111110111111101011111
101000100010101000001010001000101000001
101110111010111111101010111010111010101
100010001010000000101000100010001010101
101011101011101111101111101111101110101
101000000000100000000000001000000000101
111111111111111111111111111111111111111
