111111111111111111111111111111111111111
100000000000000000000000000000000000001
101110101111111011101110111110111011111
100010101000000010001000000010100000001
101011101110111011101110111011101011101
101000100010001000101000100000101010001
101011101011101110101010111010101110111
101010001010001000101010001010101000001
111011101111111110111110101111101110101
100010000000100000100000100000100010101
101010101110101110111010111010111110101
101010101000100010100010100010000010101
111011101011111010111011111110111111101
100000101000001010100000100000000000101
101011111010101110101011101110111010101
101010000010101000101010001000001010101
101111111011111010111111111110111110101
101000000000001010000000000010100000101
101011101011111011111111111111111011101
101010001000001000100000000000000000101
101110101110111010111011101010101110111
101000101000001010100000101010101000001
101011101011101011111111101110111010101
101000101000101010000000001000001010101
101111101011111111101010111111111111101
101000001000000010001010000000000010001
101010111110101111101110111011111111101
101010100000101000000010100000000010001
101010101010101011101010111010101011101
101010101010101010001010001010101000101
101111111110111111101111101011111110111
100000001000100000000000101010000000001
111111101111111010111111101111101010101
100000000000100010000010000010001010101
101011101010101010111111101010111010111
101000101010101010001000001010001010001
101011111010111111111010101011101011101
101010000010000010000010101000101000101
111111111111111111111111111111111111111
