111111111111111111111111111111111111111
100010100000000010001010001000100010001
111010101110111111101010101010101110101
100000000010000010000000101010100010101
101010101011111110101110111110101010111
101010101010000000101000000010001000001
101111101111101110101110111010111111101
101000100000001000100010100000100010001
111011111111101111101110111111111010101
100000100000000010000010000000101000101
101110101110111010111111111110101111101
101000101000101010100000100010000010101
111110111011101011111110101110111110111
100010100000101010000000001000000000001
111010111110101010111010111011111011111
100000101000100000100010101010001010001
111011101111101111111110101011101010101
100010000000001010100010001010100010101
101111101111111010111010101110111110111
101000000010000010000010100000000010001
101011101111111011111011111110111110111
101010101000100000000010100000000010001
101010101110101110111010101111111110111
101010001000001010100000000010101000101
101110111110111010111110101110101010101
101000101010000010100010101010000010001
101011101010101111111010101011101110111
101010100000101010000010100010000010001
101110111111101010101111111010111011101
100000000000000000100010001000100000101
111111111110111111101110111011111111111
101010000000100010001000001010000010001
101011111110111010111011111010111110111
100000000000100000000000001000000010001
111110101111101110101011111011111110111
100010101010101000101010001010000010001
101111101010101011101011101010101010111
100000001000001010001000100000101000001
111111111111111111111111111111111111111
