111111111111111111111111111111111111111
100010100000000000000000001000001010001
101110111111111111111110111110101010101
100000100000101000001000001000101000101
111010111011101010101011101011111010111
100010100010100010101010101000000010001
111010101110101011101010101111111110111
100010100000001010000010001000001010001
111010111111111111111110111010101010111
100010000010001010101000001010101000001
101110101111101010101011101111101011101
101010100010000010101000101000000010001
101010111011101110101011101011111111111
100010100000000000001000101010101000101
111010111010101010101110101010101110101
100010100010101010101000101000100000101
111010111111111111101011101110111110101
100010100000101000001000101000100000001
101110101010101011101110101011111110101
100010101010100010001000101000101000101
111010111010101010111110101110101010101
100010100010001010000000100000000010101
101111101111111111111111111111111110111
100010000000000000000000001000000000001
111111101111111111111111111111111111111
100010000010100010000010100000001010001
111010101110101010111110101110111010111
101010100000101010101000100010001010001
101010101010101010101010111010101010111
100010101010001000000010000010101010001
101110111111111111101011111110111011101
100010001000001010001010001010001000101
111010111011111010111110111010111010101
100000001000100010000010001000001010001
111011101011101011101110111111101011101
100010000000101010001010001000001010001
101110101011101010111011101011101010111
100010101000001010000010000000100010001
111111111111111111111111111111111111111
