111111111111111111111111111111111111111
100000000000101000000000001000000000101
111011101111101010101111111010111011101
100000100000101010100010100010001000001
111111101111101110111110101111101011101
101010000000100000000000101000001010001
101010101110101111111111101111111111101
100000101000000000100000100000101010001
101110111011101011101110101111101010101
101010100000101010101000000000000010101
111010111110101010111011111011111011111
100000001000101000100000001000001000001
111110111110111110101011111010111110111
100000001000100000001010001010001000101
111010101011111110101111101111111111101
100010101010000000101000000010101010001
111011101111101111101011111010101011101
100000100010100010000010001000000000001
111011101110101011111010111011101110111
100000100010001000100000001000101010001
101010101111101111101110111010111011111
101010100010101010000010100010001000101
101011101110101011111110111110111011101
101000100000100010001010000010100000001
111011101010111010111010111111101011111
100010001010100010000000000000001010101
111011101011111110101011101110111110101
100010001000101010101010001000000000001
111011111010101011101111101010111010101
100000101010000000100000101010001010101
111011101110101010101011101111101010111
101010000000101010101000101010001010001
101010111110101110101011111010101110111
100010001010100010101000100000101000001
111010101011101011101011101011101110111
100010101000001000101000101000100010001
101110111011101011111110111010101110101
100010001000101000000010100010100010101
111111111111111111111111111111111111111
