111111111111111111111111111111111111111
100000100000000000000000100010001000001
101110101011111011111010101011101011111
101000101010001010001010001000001010001
111110111011101010111010111010111010101
100010100010001010000010101010001000101
101110101111101011101110101010111011101
100010100010000010001010001010101000101
111010101111111010101010111010101011111
100000000010000010100010001010000000001
111111101111111111111111111111111111111
100000000010001010001010101000100000001
111011111111101010101010101010101010111
100010100010000010100000001010001010001
111010101010111111101111111111111110111
100000001010100010000010101000001010101
101111111110101011101010101110101010101
100000100010001010001010001000100000001
101111111011101111111010111010101111111
100010000010101000001000001010101000001
111010111010101010101011101011101011101
100010100000000010100010001000101010001
101010101011101111101111111011101110111
101000101010000010000000000000101000001
111011111111101111111111101110101110111
100000000010000010000000001000100000001
111111101111111011111111111111111011111
100000101010000010000000001000000000001
111110101011111011111111101011111011111
100010100010000010001000100000101010001
101010101110111111101011101011101010101
101000000010001010000000101000100000101
111111111011101011101110101011101111111
100000100010000010001000001000100010001
111010101011101111101110101011101111101
100010001010000010001000101000101010001
101111101010111011101111101010101010111
100010001010100010000000101010100000001
111111111111111111111111111111111111111
