111111111111111111111111111111111111111
100000101000000000000010101010100010101
101011101011101111111110101010111010101
101000100000100000101010000010000000001
111110111011111011101011111010111011111
100010001000001010001010100000001000001
101110101011111110111010101111111111111
101010101010100000001000101000100010001
101011101010101111111011101011101110101
100000100010001010001000101010001010101
111110101110111010111011101011101010111
101000000000100010000000101000001000001
101110111011111011101110101011111110111
101010100000101010100010100010000000001
101011101011101010101111111010111111111
101000101000100000000010100000001000101
101011111010101111101010111010101011101
100010000010100010001000100010101000001
111011111011101011101011111011111011111
100000001000101010001000101010100000001
111110101010101111111111101010111011111
101000101010100000001010000000000000001
101111101011101111111011101010101111111
100000101010100010101010001010101010101
111011101010101110101011101111111010101
100000000010001000001000100000100010001
101111111010111110111011101011101110111
101000101000000000000000001000001000001
101110101010101111111110111110101110111
101010000010101010100000001010100000001
111011101011101010111110101011101110111
100010001000100000001010100000101000101
111011101010101111111010111011111010101
100000001010100000000010101000001010001
101110111110101010101110101011111010101
101000001000101010100010001000101010101
101110101111111011101110101011101110101
101000101000000000100010101010000000101
111111111111111111111111111111111111111
