111111111111111111111111111111111111111
100010000000001000000000001000000000001
101010111111101111111011101011111111101
101010100010100000000010101000000000101
101010101010111111111110101111111011101
101000101010000000000000000000100010001
101111101011111111101111111110101110101
100000001000100000100010000010101000101
101111111110101110111110111010111011111
101000001000101010100000100010000010001
101110111010101010101111101111111110101
100000100010101010101000101000000010101
111110101011101011101011101011111010101
100010101010001000001000100010001000101
101010101110111110111010111110101111101
101000100010000010001010000010100010001
101111111011111011101111101011101010111
101000001010000010001000101000101010001
101110111010111110111010101110101011101
100000100010001000000010100010001010001
111111101011101111111110101011101110111
100000001010100010000000101010001000101
101111111010111010111111111010111011101
101000101000101010101000000010001000101
101010101110101010101010101111101110101
100010101000101000100010101000100010101
101110101011101111111110111010111010101
100010101000001000000010100010100010101
111110101111101011111010101110111110101
100000100000000010000000101000100000101
101111111011111111111110101011101111101
100000001010000000100010101000001000001
101111101110111110101010101111111011111
101000100000101000101010100010000000001
101011111111101010101011111011111111101
101000001000001010101010000010001000101
101110101011101011101010111110101010101
100000100010001000001000000000100010001
111111111111111111111111111111111111111
