111111111111111111111111111111111111111
100000001000100000001000100000100000001
101011101010101111101010101011101111101
101010101010000000101010001010001010001
101010101011111111101111101010111010101
101010001010001000001000101010100010101
101011111010111011111010111010111010101
101000001000100010000010000010001010101
101111101110101110111011111111101010111
100000101000101010101000001000001010001
101111101011101010101111101011111011101
101000001010101000101000100010000000101
101010111010101011101010111010101111101
101010100000101010001010001000101000001
101011101111101011101011101111111011111
101000001010001000101000101000001000001
101111111010111110101110101011101011101
100000100010100000001000100000101000101
111110111010111111111011111111101111101
100010001010100000001000100000001000001
101011101010101111101110101111111011101
101000100010101010001000101000000010001
101110111010101010111011101011111110111
101000100010001010000010001000100010001
111010101111111011111110111110101111101
100010100000100000001000100000100000101
101011111110101111101011101111101011101
101010000010101000001010100000101000001
101110111010101111101110101110101111101
101000101010100000100000101000101000101
101011101010101110111111101011111010111
100010001010100010001000001000000010001
101111101010101111101011111111111111101
100000001000101000100000100000001000101
111111101111111010111011101111101010101
100000001000000010001010001000101010101
101111111111101111101110111010101010101
100000000000001000000000100010000010001
111111111111111111111111111111111111111
