111111111111111111111111111111111111111
101000000000100010001010000010101000001
101011111110101010101010111010101011101
100010100010101010100010001010101010001
101110101010101010111011111010101010111
100000001010101010001010000010100010001
111011111010101111101010101110111111101
101010000010100010001010100010100000001
101010111110101010111110111010101111111
100010001000101000100010001000100000001
101111101111111011101011101111111111101
101000000000001010001000100010000000101
101111111011101010111010111010111010101
101000100010101010001010001010001010101
101010101110101011101011101011101110101
100010100010001000101000100010100010001
111110111011111010101111111110111010111
100010001000000010100000000000100010001
101111111110101110111111101110111111101
100000100000101010100010001010000010101
111110101111101010101010111011101010101
100000101000101010101010001010001000001
101011101011101010101011101010111111111
101010001000001000101010001010100010001
101110101111111110101010111010101010111
100010100000100000101000100010001000001
111010111110111111101111101011111111101
100010001000100000100000101000001000001
101111101011101110111110101111101011111
100000001000000010100000100010100010001
111010111111111110101110111010111110101
100010001000000000100010101000001000101
101111101011111111111010101111101111101
101000101010000010001010001000101000001
101010111010101010101010111110101011111
101010001010101010101010000010100000101
101111101011101010101011111010111110101
100000001000001000100010000000100000001
111111111111111111111111111111111111111
