111111111111111111111111111111111111111
100000000010000000100000000000000000101
101011111010111110101111111111101110101
101000001010100000101000000010100010001
101111101010101111101111101010111011101
101000001000100010001000001000101000101
101011111111111110111011111110101110101
101000001000100000100010000000100010101
101111101010101111101111111110111010111
100010100010101000001000000010000010001
111010111110101010111011111011111011111
100010001010101010100000001000100000001
101110101010101110101111111010111111101
100000100010100010101010001010001000001
111111111010111010101010101110101011111
101000100010000010000010100010101000001
101010101111111111111110111010101111101
100010100010000000000010001010101010001
101110111011111110111011101011101010111
100010001000000000101000001000001010001
111010111111111111101111111111111011101
101010000000001000000000100000000000101
101011111110111010111110101111111111101
101000100010000010000010101000001000001
101110111011111111111010101011101011111
100010001000000010001010100000101000001
101111101111101010101010111111101111101
100000101000101000101010000000000000101
111010101010101111101011111011111111101
100010100010101000001010001010000010001
101011111110111011111010101010111010111
101010000010000010000010101010101000101
101110101110111110101111101010101111101
100000100000100000101000100010100000101
101111111111101111111010111110111010101
100000100010001000100010000010001010001
111110111010111010101111111011101011101
100000000010000010000000001000000010001
111111111111111111111111111111111111111
