111111111111111111111111111111111111111
100000001010000010001000001000100000001
101111101010101010101110101010111011101
101010001000101000100000100010001010001
101010111111101111101111111111101010111
101010001000001000001000100000001010001
101010101011111111111011101110111011101
100010100010000010001010001000100010001
111110111111111010101010111011111111101
100010100000100010100010001010000000001
101010101010101011111011101010111111111
101000101010101000001010001010100000001
101110111010101110101011111010101111101
100010000010100010100010001010001000101
111010111110111011111110101011101011101
100010100010001000000010101000101000101
111110101011101011111010101110101010101
100010001010001010001000100000001010001
101011111010111110101111111111111111111
101000100010100010100000001000001000101
101010101110101010111111101011101010101
101010100010101010000000101000100010001
101110111010111011101110101011111111101
100010100010000010001000101000001010001
101010101110111110111111101011101010111
101010001000100010000010001010001000001
101011111011101011111010111011111111101
101010101000101010001010001010000000101
111010101010101010101111101010111110101
100010100010101010100000000010100010101
101110111110101011101111111010101110101
100010001000101000100010001010100010101
101011101011111010101010101010101010111
101000001000001010101010100010001010001
101111101111101110111010111110111011101
100000101000101000100010000000101010101
111110101010101011101111111111101010101
100000100010100000001000000000000010001
111111111111111111111111111111111111111
