111111111111111111111111111111111111111
100010000000100000000010000000000010001
101110101111101110111011111011111010101
100000100010001000100000001000001000101
111111111010111011111111101011101111101
100000000010001000100000101010001010001
101011111111101110101110101110111010111
101010000010001010001010100000100000101
101110111010111011111010111111101111101
100010101000000000000010101000101000001
101010101111111111111110101010101110101
101000100000100000000000100010101000101
101111101110101011111111101110101011101
100000001000101010000010001000101000101
111111111011101110111011111011101110101
100000100000101000101000001010001000101
101110111111101011101111101010111011111
100010100000101010100010001010100010001
111010101110101010101011111010111010101
100010101010101010001000100010001000101
101110101010101011111010101011101011101
100010001000001000000010101000101000101
101011111111111111111110101111101110101
101000100000000000001000100000001000101
101110101111111011111011101111111111101
100010100000101000001010101000000000001
111110111110101111101010101111101011111
100000001000001000001010100000101000001
101111111011111011111010111110111111101
100000100010100010000010000010001000001
111110101110101110111110111011101011101
100010001000100000100000001000101000101
101111111011111111101111111010101110101
100010001000000000100010100010100000101
101010101010111111111010101111111111101
101000100010100000001010101000000010001
101111111110101110111010101011101110111
100000000010000010000000100000100000001
111111111111111111111111111111111111111
