111111111111111111111111111111111111111
100000000000000000000000000000000000001
111010101110111010101011101111101110111
100010100010100010101010001000000010001
101010101110111110101111101110111010111
101010101000100000100000101000001010001
101110111010111110101110101010111111101
101000100010000010101000101010000000101
101111111110111111101011111010101111101
100000000010001000001000100010101000001
111011101110111111101111101110101110101
100010001000001000001000000010101000101
111010101010111110111011101010101011101
100010101010000010001000101010101010001
101111111111111111101110101111101011101
100000100000000000000010100010001000101
101111101010101110111011111010101011101
100000101010101000100000100010101010001
101010111111111010111011101110101011101
101010001000000010001010000010101010001
101011111011111110111010101010101111111
101000001010000000100010101010100000001
111010101010101110101110101010101110101
100010101010100010100010101010101000101
101010101010101111101010111010111111101
101010101010101000001010001010100000001
101010101111111110101111111011101010101
101010100000100000100000001000101010101
111010111011101110101110111110111011101
100010100010001000100010000010001000101
101110101011111111101010111011111011101
101000101000001000001010100000100000101
101011111111101010111010111110111010101
101000100000001010100010000010100010101
101111111010111011101011111011101111101
100010000010100010001000100000101000001
101110111010101010111011111010101011101
101000001010101010001010000010101000101
111111111111111111111111111111111111111
