111111111111111111111111111111111111111
101000001000000000100000101000100000101
101010101011101010101010101011101010101
100010100010001010001010001000001010001
111111111011111111111111111010101110101
100010100000000010100010001010101000101
101010101110111010101111101111111110111
101000000010001000000000001010000010001
111111111111111111111110111011101011101
101010101000001010101010101010001000001
101010101010111010101010101010111111111
100010100010100010100010001000000010101
111010101010101010101010111011101110101
100010101010001010101000001010100000001
101110111011111010111111101010101110101
101010100000001010000000101010000010101
101010101110111010101011101011111111111
100000000010001010101000001000100000001
111011111011111111111110111010111111101
100010000000000000000000001010000010001
111011111111111110111111111011111010101
101000101010000010000000001000100010101
101110101010111111101011101011111011101
101000100010001010001010001000100000001
101011111010101010111111101110111111111
100010000010100010001010001000101010101
101010101110111110101010111010101010101
101000100000000010100010001010000000001
111111111111111011111111111111111111101
100000000000001010000000001010000000101
111010101111101011101111101011101110101
100010100010000010100010001010001000101
101110101111101110101111101010101011101
100010100010000000000010001010101000001
101011101111101011111010111011101111101
101010100010001010000010001000000000101
101110101010101011111010111010101110101
100010001010101010000010000010100010101
111111111111111111111111111111111111111
