111111111111111111111111111111111111111
100000000000000000000000000000000000001
101111101011111010111011111111101110111
100000101000001010100000000000101000001
111111111110111111101011111011111110111
100000000000000010001000100000100000001
111011111011111011101110101010101011101
100000100000100010000010101010101010001
101111101111101010111010101110111010101
100000100000101010001010100010001010101
101110101110101110111111101010111011101
100010101000101000001000001010100000101
101110101110111111101111111110111010101
101000100010001000000000001000100010101
111110101111111011111111101010101010101
100000101000000000000000101010101010101
101011111011101010111111101011101111101
101010000010001010100000001010000010001
101010111010101111101111101011111010101
101010001010100010001000001000001010101
101111101011101111101010101110101111111
100000101010001000001010101000100000001
111110111011111011111110101011111110101
100000001010000000001000101010000000101
101011101110101010111011101110101111101
101000101000101010001000100010100010001
111010101011111110101110111011111111101
100010101000100000101000100000000010001
101011101110111011111011111010101010111
101010001000001010000000100010101010001
111111111111111010111010101110111010111
100000000000000010100010100010001010001
101010101010101011101110111011111011111
101010101010101000101000100010000000001
101010111111111011101111111110111110101
101010000000001000101000000000000010101
111110101011101010101011101110101111101
100000101010001010101000100010100000101
111111111111111111111111111111111111111
