111111111111111111111111111111111111111
101000001000100010001000001000100000001
101011101011101010101011101110101111101
101000101000001000100010000000101000001
101110101111111111111010111110101011111
101000100000100000100010100010101010001
101011111010101111101110111010111010101
100010100010001000100010100010000010101
101110101111111010111010101111111010101
100010101000001010000010001010000000101
111010101010111010111111111010111111101
101000101010000010100000001010000000101
101110111011111110101111101011111110111
100010000010000000100010100010000010001
101110101111111110111010111010111110101
100010100000000010101000001010001000101
111010111111111010101111101110101011101
100010001000001010001000100010100010001
101111111011111011111010111010111110111
100010000000000010000010000010000010001
111010101111101110111111111110111111101
100010101000100000000000100010100010101
101111101110111111111110101010101010101
100000001000100010001000101000101000101
111111101011101010101011101110101111101
100000100010001010100010100010100000101
111010111111101110111110111010111110101
100010000000100010000010001010101000101
101111111010111011111010111010101011101
101000100010101010000010100010001000101
101010101110101010111110101110111110101
101010100010101010100000100010000010001
101010111010101010101011111011111011111
101010001010001010101010000000101000001
101011101011101010111010111110101011101
101010101000100010000010001000101000101
101010101111111111111011101111101110101
100000100000000000000010000010000000101
111111111111111111111111111111111111111
