1111111111111111111111111
1000100000100000100010001
1011101011101110101110111
1010001010101000000010001
1010111110111010101110101
1000001010100010100010101
1010111010101111101110111
1010101000101000100000101
1011101011111110101111101
1000100010101000000000101
1010111010101010111111101
1010100010101010101000101
1011111010101110101010101
1000000000100000000010101
1010111110111110101111101
1010100010001000100000101
1011111010101111101111101
1000001000100000100000001
1011111011111110101111111
1000001010000000000010001
1011111111101011101010111
1010101000001010001000001
1010101010101110101111111
1000100010101000100000001
1111111111111111111111111
