1111111111111111111111111
1000001000001000100000001
1010111010101110101011101
1010100010100000101000101
1010101110111110101110111
1010100010000010100010001
1110111011111011101111101
1000001010001000001000001
1011111010101111111011101
1000100010100010000010001
1110101111101010111111111
1000100000101010000000001
1011111110111011111111101
1000000010001000001000001
1011111011101110101011101
1010100000100010101000101
1010101111111010101110111
1000100000000010100010001
1110111111111110111011111
1000100000000010100010001
1011111111101010101111101
1000000010001010101000101
1111111010111010101010101
1000000000100000100010001
1111111111111111111111111
