1111111111111111111111111
1000001000000010001000001
1110111010111010111011101
1000100010100000100010001
1011101110111111101110101
1000001010000000100010101
1011111011111110111010101
1000000000000010001010101
1111111111101111101010101
1000100000101010001010101
1010101110111010111010111
1010001010000010000010001
1011111011111111111110101
1010000000100000000010101
1011111110101110111011101
1010000010100010100010001
1010111010111010111010101
1000101010000010001000101
1111101011111111101111101
1000100010000010001000001
1010101110111010111110111
1010100010100010000010001
1011111010101111111011101
1000000000100000000010001
1111111111111111111111111
