1111111111111111111111111
1010101000001010001000001
1010101010111011101011111
1010000010100010000000001
1011101111101111101110101
1010001010000000100010101
1011101011111011101011111
1000101000100000101010001
1110101011111011101110111
1000000010100010101000001
1111111010101010101011111
1010000000101000001000001
1010111011111011111010101
1010100000101000100010101
1011111011101011101011101
1000001010100010001010101
1110111010111010111110111
1000000000000000000000001
1110111110111110101111111
1010100000001000100000001
1011101110101110101111101
1010001000101000101000101
1010111110111111101011101
1000100000000000100000101
1111111111111111111111111
