1111111111111111111111111
1000100000100010000000001
1010101011111011101110111
1010001000100000001000101
1111111011101110111110101
1000101000100010001000001
1010101110111111111110111
1010000000100010001010101
1111101111101111101010101
1000000000001000000010101
1111111110101011101010101
1000000000100010001010101
1111101111111111101110101
1010100000100010000000101
1010101010101110111010101
1000001010100010100010101
1010111010101110101110101
1010100010100000100010001
1011111011111110111111111
1010001000101010001000001
1011101110101011101010111
1010000000100010001010001
1011111111101011101011101
1000000000101000000010001
1111111111111111111111111
