1111111111111111111111111
1000001000000010001000001
1110111010111110101010111
1000100010001000100010001
1011101111101011111111101
1000001000101010000010001
1011111010101010111010111
1000001010100010001010001
1111101010101111101011101
1000101010100000101010001
1010101010111111101010101
1010001010000000001010101
1011111011111110111010101
1010001000100010101000101
1011101110101011101111101
1010000010001000101000101
1010111011111110101010101
1000100010001000100010101
1111101111101010111110111
1010001000001010000010001
1010111011101011111111101
1000100010101000100010001
1011111010101110101010111
1000000010000010001000001
1111111111111111111111111
