1111111111111111111111111
1010001000100000001010001
1010101010101111101010101
1000100010001000100010101
1011111111111010111010101
1000100000100010100000101
1110111010101111101111101
1000100010001010001010001
1011101111111010101010101
1000101000000010101000101
1110101011101010111111101
1000100000101010100000101
1011111110111010101110101
1000000010001000100010101
1110111110101110101110101
1010000010100010101000101
1011111010111010101011111
1010000010100010101010001
1010111111101110111010101
1010000000101010001000101
1011111110101010111110101
1000000010100010100010101
1011111010111110101011101
1000001000000010001000001
1111111111111111111111111
