1111111111111111111111111
1010100000100010100010001
1010101110101110111011101
1000000010100000101000101
1010111011101111101011101
1010001000001010100000101
1110111110101010101110101
1000001010100010001000001
1111111010111011101111101
1000101010101010100010001
1110101010101010101111101
1010001000001000000010001
1010111010111110111010101
1000100010100000101010101
1010111110101111101110111
1010000010100000100010001
1110101110111011111010111
1000100000101000100000101
1010111110101011111110101
1010100010100000100010001
1010101110101011101110101
1010001000101010000010101
1011101110111011101110101
1010001000001000001000101
1111111111111111111111111
