1111111111111111111111111
1010000010101000000000001
1011101110101011111010111
1010000000100010001010001
1010111010101010111111111
1000100010001000000000101
1010111011111011101010101
1010100010001010001010001
1111111010111111111110101
1000000000000010001010101
1111101110111110111011111
1000001000100010100000101
1111101110101110101111101
1000000010000000101010001
1110111011101111101011101
1000001010100000000000001
1110111010111011101011101
1000001000100010001000101
1111111010101111111011111
1010000010100010100000001
1011101111111010111010101
1010100000100000001010101
1010101010111011111110111
1000001010100000001000001
1111111111111111111111111
