1111111111111111111111111
1000000000000000000000001
1010101110101010111111101
1010100010101010000010001
1011111010111111111010111
1000100010100000000010001
1010101111111111101010101
1010100000001000001010101
1010111011111011111110101
1010100010000010000000101
1011101111111010101110111
1010000000100010100010001
1010111011101010101010101
1010100000101010101010101
1111101011111010111111101
1000001010000010100000001
1110101011101111111110101
1000101010001000000000101
1011101011111011111111101
1010001010000000000010001
1011101011111010111010111
1010001010000010100010001
1011111010111010101110111
1010000010100010100010001
1111111111111111111111111
