1111111111111111111111111
1000100010001000001000001
1011101010101011101110101
1010001000101010100010101
1010111111101010111010101
1000100000100000101010101
1011101110111110101011101
1010001010000010001010001
1010111011111111101010111
1010000000100000101010001
1011111110101110111010101
1010000010001010000010101
1010111011111011111111101
1010001000001010000000101
1011111011101010101110101
1000000010001000101010101
1111111110111011101010101
1000000010001000101000101
1011111111101011101011101
1000100000001010001010001
1010101111111010111010101
1010101000001010101010101
1010101011101110101010101
1010000010000000100000101
1111111111111111111111111
