1111111111111111111111111
1000000010000010101010001
1111111010111010101011101
1000100010001000101000001
1110101111101111101011101
1000000010000000101010001
1110101110101011101111101
1000100000101000101000001
1111101111111110101010101
1000000010000000001010101
1110111111101111111110111
1000000010000000100000001
1110101110101110101011111
1000100010100010001000001
1111111110111111111010111
1000000010100010001010001
1010101010111011101011111
1010101010100000001010101
1110111110111110111010101
1000001000001000101000001
1110111010101110101110111
1000001010100000101000101
1010111010101011101011101
1010000010101000001000001
1111111111111111111111111
