1111111111111111111111111
1010000010000000001010001
1010101011101111111010101
1000101010000000001000101
1111111010111110111110111
1000100000100010001000101
1110111010101110101110101
1000100010100000101000101
1110101010111011101110101
1000101010100010001000001
1011111010111110111111101
1000000010100000001000001
1111111011111111111110111
1000001000101000000000001
1011101110101110111110101
1000101000001010001000101
1111101010101010101111101
1000000010101000101010001
1111111011111111101010101
1010101000000000001000101
1010101111101011111011111
1000000010101000001000001
1010101010101010111110111
1010101000001010001000001
1111111111111111111111111
