1111111111111111111111111
1000000000001000100010001
1011111011101010101010101
1000100010001010101000101
1110101110111010101111101
1010100010100010001000101
1010111011101111111011101
1010101000001000100000101
1010101111111010111010101
1000100000000010001010101
1011101111111011101010101
1000101000001010001010101
1110101011101010111110101
1000101010101010001000101
1011101010101011101011101
1000100010001010101010001
1110111110111010101010111
1000100010100010000010001
1011101010101110111111101
1010001000101000001000001
1010111111101011111011111
1010100000101010001000001
1011101110101010111111101
1000001000001010000000001
1111111111111111111111111
