1111111111111111111111111
1000100000100000100010101
1010111110111011101110101
1010100010000000000000001
1011101110101111101011111
1000001000100000101000101
1011101011101111101010101
1000100000100010001010101
1011111111111111101110101
1000101000001010000010001
1011101111101011101011111
1000100010100010001000101
1011101110111011111110101
1000000000000000000010001
1011101111111111111111111
1010100010100000001010001
1010111110101111101010111
1000000000101010000010001
1111101111101011111011101
1000000010101010100000001
1111101110101010111011111
1000000010000000100000001
1011111010111111111110111
1000001000000000100000001
1111111111111111111111111
