1111111111111111111111111
1000000000100000000010001
1011111110101111111010111
1010000010100010001000001
1010111011111010101011101
1010001000001000101010101
1011101110111111101010101
1000101010100010001010001
1010101010101110111011101
1010101010000010001010001
1110101011111011101011111
1000100010001000001000001
1010111110101111111010111
1010100000100010000010001
1010101011111011101111101
1010101010000000101000001
1010101110111110111011111
1010100010100000100010001
1011101110101111101110101
1000101010100000100000101
1110101010101111111111101
1000101000100010000010001
1011101011111010101110101
1000001000001000100000101
1111111111111111111111111
