1111111111111111111111111
1010100010100000000000001
1010101110101010101110111
1000100000101010100010001
1011111011111110111011101
1010101010000000101000101
1010101010101111101111111
1000000010101000000000001
1111111011101010101110101
1000000010000010100010101
1110101111111010111010111
1010101010100010100010001
1010101010111110111011111
1000101010001000100010101
1011101010101111111010101
1010001010100010000000001
1110111010111011111110101
1000001000001010100000101
1111101110101010111011111
1010001010101010001010001
1011101010111011101010111
1000000010001000000000001
1110111010101111101011101
1000001000101000001000101
1111111111111111111111111
