1111111111111111111111111
1010000000000000000000001
1010111111101111101111111
1010100000100010101000001
1010101111111010101011111
1010100010000010001010001
1010111010111111111010101
1010000010000000001000101
1011111011111111101111101
1000100010000000100000101
1011101110111110111110101
1000101000001010000010001
1010101111101010111011111
1010100010001010101010001
1110111010111010101010101
1000001010000010100010101
1011101011111110101111101
1010101000001000100000001
1010101111101011111111101
1010000000101000000000101
1011111111101111111110101
1000100000001000000000101
1010101111111011111111101
1010000000000010000000001
1111111111111111111111111
