1111111111111111111111111
1000000000100010000000001
1111111010101111111111101
1010100010000010001000001
1010101010101110111111101
1000001010100000000000001
1111111010111011101110111
1000100010100010001000101
1011101110111010111110101
1000000010100010101010001
1110111110101110101010101
1010100010100010001000101
1010101011101111111111111
1000001010100010100010001
1111111010101010101010101
1000000010001000001000101
1110111111111111111011111
1000100010001000000010001
1011101110111010111010101
1000000010100010100010101
1110111110101011101110111
1010101010001010000000001
1010101011101111101010111
1000000010000010001010001
1111111111111111111111111
