1111111111111111111111111
1000100010001010100000101
1110111011101010101111101
1010100000100000000000001
1010111110101111101011111
1000001010000000101000001
1110111010101010111010111
1000100000101010100010001
1110111110111111111110111
1000100000100000001000001
1110111110111011111111111
1000001010001000000000101
1110111010111011111111101
1010101000100010001000001
1010101011111010111011111
1000000000100000101010001
1111101011101111101010111
1000001000100010000000001
1111111011101111101011111
1010100000000000001010101
1010111011111010111110101
1000100010001010101000001
1110101110111011101110101
1000000000001000000000101
1111111111111111111111111
