1111111111111111111111111
1000000000000000000000001
1011111011111011101010101
1010000010000010001010101
1110111111101011101010101
1000001000001000101010101
1011101111111011101111101
1010000010000000101000001
1011111011101010101011101
1000001000101010101000101
1011101110101010111010111
1000101000101010001010001
1010111111111111111011111
1010000000000010000000001
1011111111111011111110101
1000000000001000001000101
1011111011111110111010101
1010000000001000100010101
1011101010101110111110101
1000101010101000000010101
1110101011101011101010101
1000101010001010001010101
1111101110101011101011101
1000000010101010001010001
1111111111111111111111111
