1111111111111111111111111
1000100010000000001010001
1110101011101011111010101
1000101000001010001000101
1011101010101010101010101
1000001010101010100010101
1011111011111010111011111
1010101010001000001000101
1010101010111110111011101
1000001000100000100000101
1010101110111111101110101
1010101010001010101000001
1111111011111010101111101
1000001010000010001000101
1011101010101010111011111
1000101000101010001010001
1010111011111111101010101
1010000010101010001000101
1010101010101011101011101
1010101000000000101010101
1010101110111011101010101
1010100010101010000000101
1110101011101010101110111
1000101010000000101000001
1111111111111111111111111
