1111111111111111111111111
1000100000000000000000001
1010101111111111101111101
1010101000001000001000101
1010111011101011111110101
1010001010001000001000101
1010101110111111101011101
1010100010101000101010001
1011111010101010101010111
1000001000101010001010001
1111101111101011111011101
1000101000001000001000101
1110101011111011101011101
1000000010001000100010001
1011111110111110111110111
1010000000000010100010001
1011111011111110101011101
1000100000000010001000101
1110101011111011111110101
1000101010001000100000101
1011101010101110111111101
1000001000100010000010001
1111111111111010111010111
1000000000000010001000001
1111111111111111111111111
