1111111111111111111111111
1000000000000000000000001
1011111110101111101111101
1000000010100010001000001
1010101110111010111010101
1010100010001010100010101
1110101111101011111011101
1000100000101000100010001
1011101111101111111010101
1000100010000000100010101
1011101111101011111010101
1010000010001000100010101
1011101011111010111011111
1010001010000010001000001
1111101010111011111110101
1000001010100000000010101
1011111111111011101111101
1000000000100000101000001
1011111011111111111010101
1000100000000000100010101
1111101111111010111011101
1000001000000010100000101
1010101111101111111011101
1010100000101000000010001
1111111111111111111111111
