1111111111111111111111111
1000001010001010001000001
1011101011101010111110111
1000100010000000101010001
1011111011101010101010111
1010000000101010001000101
1110111011111111101011101
1010001000101000000010001
1011111011101110101010111
1010000010000000101000001
1011101111111111101111101
1010001010101010001010001
1010111010101010111010111
1010000000000000100000001
1011111011111111101010111
1000000000001000001010101
1111101011101010101111101
1010101010101010100000001
1010111010101110101111111
1000000010000010100000001
1111111010101111101111101
1010000010101010000010001
1010101111101011101010101
1000100000100010001010101
1111111111111111111111111
