1111111111111111111111111
1010100000100000000010001
1010101111101111101110111
1010100000001000100000001
1010111110101011111111111
1010100000100000001000001
1010111011101011111110101
1010000000101000001010101
1010111010111111111010101
1010100010001000001000101
1010111110111011111110111
1000100010101010100010001
1011101011101010101010101
1000001000001000001000101
1010101011101110101011101
1010101000100000101010001
1110111110111110111111101
1000001000000010100000001
1111111111101111111110111
1010100000000000101010001
1010101011101110101011101
1000001010101000100010001
1111101010101110101011101
1000001010000010001010001
1111111111111111111111111
