1111111111111111111111111
1000000000000000000000001
1010111110111011111111101
1010000010001010000000001
1010101111101010111110101
1010100000101010100000101
1011101111101110101110101
1010001000000010100010101
1010111111111111101111101
1010000010000000000000101
1010111111111010111010101
1010001000000010001010101
1010111110111110111010111
1010001000001000001010001
1110111110101110101110101
1000000010100010101000101
1011101111101111111111101
1010000000101000000000001
1010101011101111111011111
1010101010000010000000001
1010111010111111101110101
1010001010000000100010101
1010111011111010101011111
1010100000100010101000001
1111111111111111111111111
