1111111111111111111111111
1000101000001000000000101
1010101010101011111110101
1010001010100010000010101
1010111010111110111110101
1010100010000010001000101
1011101111111010101011101
1000101000100010100000101
1010101010101011111110101
1010001010101010000010001
1011111010101010111011101
1000001010101010100010001
1111101010101110101111101
1000101010101000100000101
1011101011101011111110111
1000101000100010000010001
1110101110111111111011101
1000100010001000000010101
1011111010101011111010101
1000100010100010000000101
1010101110111110111111101
1010001000001000100000101
1011111111101111101110101
1000000000001000001000001
1111111111111111111111111
