1111111111111111111111111
1000000000000000000000001
1010111010111111111111101
1010100010000000001000001
1010101111101110111110101
1010101000001000100000101
1011111111111011101110101
1010000000000010001000101
1011111011111111101110111
1010000000000000100010001
1010101010111010111111101
1010101010100010000010001
1110101110101111101110101
1000101000101000000010101
1011101010101011101110101
1000101010101000100010101
1010101110111010101010101
1010101000001010101010101
1010111111111010101010101
1010100000000010101010101
1110101011101011101110101
1000101000101000101000101
1011101110111111101010101
1010001000001000001010101
1111111111111111111111111
