1111111111111111111111111
1010000010000000001000101
1011111011101111111011101
1000000000001000001010001
1010101110101011101010111
1010100010101010000000001
1111101111111110111111101
1000001000000000000010001
1011111111111011111111101
1000000000000000001000101
1110101111101110111110111
1010101000001000000000101
1010101111101111111111101
1000100010000010000000001
1111101011101110111011111
1000001010000010101000001
1010111110111011101110111
1010000010001000001000001
1111111011101110111011111
1010000000101010000000001
1010111110111011101111101
1000101000000010001010101
1010101011111110101010101
1010001000100000101000001
1111111111111111111111111
