1111111111111111111111111
1000001010000000001000001
1011101010111111101011101
1000101000100000100010001
1010101110101011111110111
1010100000101000000010001
1110111110111111111011101
1000000010100000001000101
1011111010101111101010101
1010001010100010001010001
1011101011111010111111111
1000100010001010000010001
1010111110101011111010101
1010000000101000101000101
1111111111101110101111101
1010001000001000100000101
1010101011111011101111101
1000101000001010101000001
1111101111101010101010111
1000001000001000001010001
1011111010111011111010111
1000001010100010000010001
1111101010101110111111101
1000000010001000100000001
1111111111111111111111111
