1111111111111111111111111
1000000000000000000000001
1010101110101011101010101
1010101000101000101010101
1011111111101110101110101
1000100000000010101000101
1010101010111011111110101
1010101010100000100000101
1010101010111010111110111
1010101010001010100000001
1011111111111011111010101
1010000000000000001010101
1110101010101110101111101
1000101010101000100010001
1110101010111111101010111
1000101010000000101010001
1111111111101111111010101
1000000000001000000010101
1110111110101110101111111
1000000010101000100000001
1010111111101110111110111
1010100000001000000010001
1010101011111010101111101
1010101000001010101000001
1111111111111111111111111
