1111111111111111111111111
1000000000000000000000001
1010101110111110111111101
1010100010001000000010001
1010101111101110111111101
1010101000000010000010001
1111111011101010111110101
1000000000101010001000101
1110111011111110101111101
1000001000001000101000001
1011111010111110101111101
1010000010000010100010001
1011101010101111101010101
1010001010100000101010101
1110111011101010101110101
1000100010001010101000101
1010101010101111101011101
1010101010100000101000101
1110101010101011101011101
1000101010101000101000101
1111101010101111111110101
1000001010100000100000101
1011101111111111101010101
1010000000000000101010101
1111111111111111111111111
