1111111111111111111111111
1000000000000000000000001
1110101010101110111110101
1000101010100010100000101
1010111010101010101111101
1010001010101010101000001
1011101110111011101110101
1000101000001010001000101
1011111011101110101111101
1000100000101000101000001
1011101110111111101010111
1010000010100000001010001
1011111110101011101010111
1010000000101010001010001
1011101010111110101111111
1000101010100000100000001
1110101110101011111010111
1000101000101010000010001
1011111111111010111010111
1000100000000010001010001
1010101110111011111011101
1010100010001010000010001
1111111111101110111010111
1000000000001000100010001
1111111111111111111111111
