1111111111111111111111111
1000100010000010000010001
1011101011101010111011101
1000001010001000100000001
1010111111111011111110101
1010000010001000101010101
1011101110101010101010111
1010100000101010001000101
1010111011101110111110101
1010100010101000001000001
1010101110101111111110111
1000100010100000101000001
1110111110101010101010101
1010100010001010001010101
1011101110111110101010111
1000100010001000100010001
1110101010111111111110111
1000101010000000100000101
1010111011111011111110101
1010001000000000001000001
1110101011111110111010111
1000100010000010101010001
1011101111101010101011111
1010000010001000100000001
1111111111111111111111111
