1111111111111111111111111
1000100010101010000010101
1110101010101011111010101
1010101000000010100010001
1010111011111110111010111
1000000000101000000010001
1010111011101111111010111
1010100000101010001000101
1011111010101010111110101
1010100010001000001010101
1010111110101011111010101
1010000000101000100000001
1110111110111011111110111
1000000010000000101000101
1011111111111011101110101
1010101000101000100000001
1110101011101110111110111
1010001000001010101000101
1011101111101010101110101
1000000010000000001000101
1111101110111010111011101
1000101000100010000000001
1110101111111110111011101
1000000000000000001010001
1111111111111111111111111
