1111111111111111111111111
1000000010000000000000001
1111101110111111111111101
1000100000100010000000101
1010101111101110111110101
1010100000101000100010101
1010111110101011111010101
1010000010001000001000001
1011111011111011101111111
1010001000001000100010001
1010101111101011111010101
1010100000101010001010101
1010101110101110101010101
1010100010100000101000101
1011111011111111101011101
1000001000100000101000101
1111101010101110101111101
1000101010100010101000001
1110101010111010101011101
1000101010001010101010001
1011111111101010101010111
1000100000001010001010001
1010101011111011111011101
1010001000000000000010001
1111111111111111111111111
