1111111111111111111111111
1010001000001010000000001
1010101011101010111111101
1000100010000010001000101
1111111110111011101010111
1000000010001010000010001
1010101111111011111111101
1010101000000010001000001
1011101011111110101011101
1010001000000010100010001
1010111011111010111110111
1010100010000010001010001
1010101110111111101011101
1010001000100000001000101
1011111011101111111010101
1010001000101010000010101
1010111110101010111110101
1010100000100010100010101
1010101111111011101010101
1010100000100010001000101
1010111010101110111110101
1000100010101010001010001
1110101111101010101010111
1000100000001000100010001
1111111111111111111111111
