1111111111111111111111111
1000001000001000100010001
1011101011101011101010101
1000100010101000001010101
1110101110101111111010101
1010101000000010001000101
1010111111111010101011111
1010100000001000101000001
1010101011101110111011101
1010001010001000100010001
1011111010111111101110111
1010100010100000100010001
1010101110111010111110101
1000101000001010100000101
1011101111101110101011111
1000100000100010001010001
1110111111111010111010101
1010000000001010001000101
1011111111101011101111101
1000100000000010000010001
1010101111101011111011101
1010100010001000100000101
1011111010101110111110101
1000000010100010000000101
1111111111111111111111111
