1111111111111111111111111
1000100010000000000000001
1010101010111011101111101
1010001010101000101000101
1011111010101110111010111
1010000010001010001010001
1011111111111011101011101
1010000010000000001000101
1010111010111111111111101
1000100010001000000000001
1111101111101111101111101
1000000010101000001000001
1011111010101011111111111
1000001000100000000000001
1011101110111111111010111
1010001000100000001010001
1010111111101111101111101
1010100000101000100000001
1011111110101011111010111
1000001000101010001010001
1111101011101010101111101
1000001000000010101000001
1011101111111110101011111
1000100000000000100000001
1111111111111111111111111
