1111111111111111111111111
1000000010000010000000001
1011101110111111111010111
1010000010000010001010101
1011101110111110111011101
1010000000000000001000101
1111101011111111111011101
1010101000100010100010001
1010101111101110101110111
1000000000000000000010001
1111111011101011111110111
1010100010101010001000001
1010111010111111101011101
1010000000000010000010001
1010101011111110101111111
1000101000001000100000001
1010111010111110111111111
1010001010000010101000001
1011111111111110101010111
1000000000100000000010001
1011101111101111101111101
1010000000001000100010101
1010111010111011111110111
1010100010000000000000001
1111111111111111111111111
