1111111111111111111111111
1010100000100010000000001
1010111110111011111011111
1000001000100000001000101
1010111010111110111110101
1010101010001000100000001
1110101111101110101110111
1000101010000010100010001
1110101011101110101111111
1010001000101000001000101
1011101110101110111011101
1010000010001010001010101
1011101111101010111010101
1010101000000000001000001
1010101110101110111011111
1010000000101010000010001
1011101011111011111011101
1010101010000010001000001
1010111111111010111010101
1000000000000000000010101
1010101110101110111011101
1010101000101000101010001
1110111010111110101011101
1000100010001000100000101
1111111111111111111111111
