1111111111111111111111111
1000100000101000100010101
1110111011101110101110101
1000001010000000101000001
1110101010101011101111101
1000100000101000100000101
1010101010111011111010101
1010101010001000000010001
1011111111101111111010101
1010001010000010001010101
1110101011111111101011101
1010100000100000100000101
1011111010101111111110111
1000000010100000000000001
1110111010111010111010101
1010101010000010001010101
1011101010111111101110111
1010101010100000000010101
1010101110101011111110101
1000001010101010000000001
1011111011101011101111101
1000100000001000101000101
1011111010101111101010101
1000000010101000001010001
1111111111111111111111111
