1111111111111111111111111
1010001010000010000000001
1010111010101111101111111
1000001010100010000000001
1011111011101111111110111
1000101010000000001010101
1010101011101010111010101
1010000000001010000000001
1111111011111110111110111
1000000010101010001000001
1010101110101011101010101
1010100010100010001010101
1010101010101111111111101
1010101000100010000000001
1111111110101111101111111
1000100000100010100000101
1010101110111010101011101
1010000010000010001000001
1010111010101111101010101
1010100010100010001010101
1111111110111111101111111
1010101010001010000000101
1010101010101010101110101
1000000000100010100010001
1111111111111111111111111
