1111111111111111111111111
1000100010100010001000001
1110101010101010101010101
1000001000001000101010101
1110111111111111111010111
1000001010001000001010001
1011111010111110101111101
1010101000001010101000001
1010101110111010101111101
1000001000000000101010001
1011111111101110101011101
1000001000001000101000001
1011101111111110101111101
1000101000000000101000001
1011111111111110111011101
1000101000001000001010001
1010101011101011101011101
1010000000100000101010001
1111111111111111101011111
1000001000101000100000101
1011101110101010101010101
1010000000101010001010001
1010111011101111101011101
1010001000000000001000101
1111111111111111111111111
