1111111111111111111111111
1010100010000000000010001
1010111011111110111010111
1000000000000010001010001
1010101111101010111110101
1010101000101000000010101
1011111110101111101110101
1000001000101000001000101
1111101010101011111011111
1000101010001000100000001
1110111011101110101110111
1000100000101010000010001
1110111111111011111010111
1000000000000010001010001
1110111011111010111011111
1010100010000000100000101
1010111111111010111011101
1010101000001010000000001
1011101111101011111011111
1000100000000000101010001
1110111110111011101010101
1000100000100000100000101
1011111010111011111010111
1000000010100000001010001
1111111111111111111111111
