1111111111111111111111111
1000000000000000000000001
1011101111111111101111111
1000101000100010100010001
1111101010101010101010101
1000001010001010001010101
1011101011111011111110101
1010101000100010000000101
1010101110101010111111101
1010000000101010001000001
1110111111111011101011111
1000100010000010001000001
1011111010111110111011111
1010000010000010001000001
1011101111111011101111101
1000101000000010100010001
1110101011111110101110111
1000001000001000101000101
1011111011101011101011101
1010001010101010001000101
1010101010101010111110101
1000101010000010000010001
1111101011111111111011111
1000001000000000000000001
1111111111111111111111111
