1111111111111111111111111111111111111111111
1000000000000000000000000000000000000000001
1111111010111110101110111111111011111110101
1000000010100000100010000000100010000000101
1010101111101110101110101110101110111110111
1010100000101000101000100010100010000010001
1010101010111011101010101110101011111111101
1010101010100000101010101000101000001000001
1010111111101111101111101011111110111110101
1010001000001000000000101000000010001000101
1110111010101011111011111111101010101011101
1000001010101010000000000000101010101000101
1010111010111011111010111010101111101110101
1010100010001000001010001010100010001000101
1010111011101011101110111011111111101111101
1010001010001000101000001000000000100000101
1010111110101111101011111110111010111011101
1010100000100010001000001000100010001000101
1010101010101011101110101111101111111110101
1010101010101010000010100010000000100000101
1010111110101010101111101011101110101110101
1010100000101010100000101010001000100010101
1011111011111011101010101010101011111111101
1010000000001010001010101010101010000000001
1011101010111111101010111010111111101010111
1010001010001000001010001010000000101010001
1011101111111011101011111111101011101111101
1010001000000000101000000000101000100000101
1110101011101010111011101110101011101110101
1000101010001010100000100010101000101000101
1010111110111110111011101110101110111011101
1010100000100000100010000010100010001000101
1011101110111110111110111110111111111010101
1000101000000010000010000010001000000010101
1111101111101111111011101110101110111010101
1000000010001000000010000010101000001010101
1110111111111111111110111010101111101010101
1000100000000000000000001010101000001010101
1011111110111011111111101010101011101110101
1010000000100000000000101010101010000010101
1010111011101010101010111110101111101110111
1010001000101010101010000010100000101000001
1111111111111111111111111111111111111111111
