1111111111111111111111111111111111111111111
1000000000000000000000000000000000000000001
1011111011101010111110111111101110111010111
1000100010001010100000100000000010001010001
1110111011101011101110111011101111101111111
1000100000101010000010100010000000100000001
1011111111101010111010111011101111111110101
1000000000101010100010100010000000001000101
1110111110111011101110111010101011101010101
1000100000001010001000001010101000101010101
1111101110101111101011111111111010101110101
1000001000100010001000000000001010101000101
1011101110101110111110111111101111101010101
1000100010100010100000000010001000001010101
1111111010111011101110111011111011111111101
1000000010001010001000001010000000000000101
1011111010101010101011101011101010111011101
1000001010101010101000101010001010100010001
1010111111101111101011111011101010101110111
1010100000000010001000100000101010101000001
1011101111101010101010101011111011111011101
1000101000001010101010101000100000100000101
1110101010101111111111111011111011111011101
1000101010100000001000000000100010000010001
1110101011101011101011101010101010101111101
1000101010001010001010001010101010100000101
1110111110111110101010101110111110111110101
1000100000001000101010101000000010000010101
1111111110111110111111101111101011111010111
1000000000000010000000100010001000100010001
1010101110111111101111111011101010101110111
1010100010000010000000001010001010100010001
1010111010101011101111101111101011111110101
1010001010101000100010000000101000100000101
1011101110101110111111101010111010101010111
1000100010101000000000101010001010101010001
1010111111111010101110101110111011101110101
1010100000000010101000101000100000100010101
1011101011111111101011101011111110111011111
1010001000001000001010001000000010100000001
1110101110111110111010101011111011101011101
1000100010000010100010101010000000101010001
1111111111111111111111111111111111111111111
