1111111111111111111111111111111111111111111
1010101010100000000000100000000010000000001
1010101010111011101111111011111010101111111
1000100000000010101000001000100000101000001
1010101010101010101011111011101011111011111
1010001010101000100000001000101010000000001
1010111111111110111111101111111010111111111
1010000010001000101000001000001000000010101
1110111010111111101110101110111011111010101
1010100010000000000000100010001000100010001
1011111110101111101110101010101010111111101
1000000000100010101010101010100010001010101
1010111010111110111011101110101110111010101
1010001010100000001010000000101000000010101
1011101111111011101011101110111111111110101
1010101000000000101010100010100000000010001
1110111010101111101010101110101010111010101
1000100010100010100000101010001010100010101
1110111011101010111110101010101010111110111
1000100010001000100000000010101010000000101
1010101111111111101111111110111110111110101
1010000000100000000000001000000010100000001
1110111110101010111111111111101010111111101
1000101000101010000010000000001010101010001
1111101010111110111111111111111011101010101
1000101010100000001000001010101000100010101
1110101110111110101010111010101110111010101
1010000000001000101010100000000000100010101
1011101110111111111110111111111011111011101
1000000010000000100010001000100000001000001
1011111111111111101111101011101011101011101
1000001000001000000010000010001010001000101
1110101011101011111110111010111110111110111
1000100010101010000000101010001010101000001
1010101010101011111110101111101010101110111
1010101000101010000000000000100010001000101
1011111111111011101011101110111011111111101
1010100010000000101010100010001010001000101
1010111011101010101010101011101010111010101
1000001000101010001010101010000010000010001
1111101010111110101010101110101110111011101
1000000010001000101010000010100000001010001
1111111111111111111111111111111111111111111
