1111111111111111111111111111111111111111111
1000000000000000000000100010101000001010101
1011111111111111101011101010101010111010101
1000000010000010101000101000000010000000001
1011111110111110111111111011111011111011101
1000000010101000000010100000001000100000101
1011111110101010101010101110111010111011111
1000001010000010101010101010100010001010101
1011111010101111111110101011111111101110101
1000100000100000001000000010100010101000001
1011101111111111111011111010111010111011111
1000101010000010101010001010100000100000001
1010101011101110101010111110101011101110111
1010001000001000001000000000101010100010001
1011101110101110111110111111111010101110111
1010100000100010100000100010000000000010001
1010101111111110101011101110111111111110101
1010101010101010001010001000101000101000101
1010111010101010101111101110101110101111111
1000000000000000100000001000000010000010101
1010111010101010101011101110111011101110101
1010100010101010101000100000001010000000101
1011111011111110101010111011111110111011101
1000001000001000101010001010000010001000001
1011101111101110111010111011101110111111111
1000100000100010100010101000000000000010001
1110111110101111111010101011101010111011101
1000000010100010101010100010101010001000001
1110111010111110101011101010111010111010111
1000001010000010100000101000001010001010001
1110111111111110111010111010111110111110101
1000100010000000001010001010000010001000101
1110101110111011101010111111111111101011111
1000000000101000101010101000001010101000001
1110111110101111111111101110111010111110111
1000100000000000000000000000000000001000101
1110111010101011111010111111101011111011101
1000100010101010001010001010001000100000001
1110111111101011101110111011111111101010101
1010000010001000001000000000000010101010101
1010101011111011101011101110101010111010101
1000101010000010001010000010101000001010101
1111111111111111111111111111111111111111111
