1111111111111111111111111111111111111111111
1000000000000000000000000000000000000000001
1011111011101110111011111011111011101111101
1010000000100010100000001010000000100000101
1110111110111010111110101110101111101111101
1000100000100010100000100010100000100000101
1010101111111111101110101110101011111010101
1010100000000010001000101000101000100010101
1010101111111010111111101010101110111010101
1010100000001010100000001010101000001010101
1011101111101110101010111111111011101010101
1000100000100010101010001000000010001010101
1010111011111111101111101010101110111011101
1010100000100000000000101010101000001000101
1110111111101110111011101010101011101011101
1000000000101000100000101010101010001000101
1110101110111010111111111110101110111010101
1000101000100010000000001000100010001010101
1010101010111011101010101010111111101111101
1010101010100000101010101010100000000010001
1010111011101111101111111011101011101110101
1010001000101000000000001010001000101000101
1010101010101110111011111010101010111110101
1010101010100010100010000010101010000010101
1011111110101011111111111010111011101010101
1010000000101000000000100010100000101010101
1110111010101010101111101111101010111111101
1000001010101010100010000010001010100000001
1010101011111111101111101010111111101111111
1010101010000000000010001010100000000000001
1010111110101110111010111110111110111011111
1010000010101000001010100000000010100000001
1011111011111011101010101110101111111110101
1010000000001010001010100010101000000000101
1110101111111111101011101110111011101011101
1000100000100000001010000010001000101000101
1110101011111111101011101111101010101111101
1000101000000000101010000000101010100000101
1011101111101110111110101010111011111011111
1010000000101000001000101010001000001000001
1010111111111111101010101110101110111011101
1010000000001000001010101000100010001010001
1111111111111111111111111111111111111111111
