1111111111111111111111111111111111111111111
1010001000100010100010000010001010001000001
1010111010101010101110111010101010101011101
1010000010001000100000001000100010101010101
1011101011111010111111101110111110101010101
1000101010100010100000100010000010100000101
1110101010101110101110101111111010111110101
1000101010001010100010101000000010001010101
1011101011111010101011101011101111101010101
1000101000100000101000001000100000001000101
1010101110101111101011111110111111111111101
1010101000101000101010000010100000100010101
1011101011111010101011111010111010101010101
1000001010000010101010000000100010101000101
1111111011101110111010111111101111101110101
1000001000001010000010100010000010000010001
1110101111111010111110101010111110111011111
1000100010000010001010001010001000100010001
1011111011101111101010111011101011101011101
1000001010001000100010100000101010001010001
1111101010111011111110111111101010111010111
1000001010001000000010100000100010100010001
1110111010111011111010101110111110101110101
1000100000000010001000100010100000100000101
1011111110111110111010111110111111111111101
1010000010001010000010100000100010000010001
1010111111101011111110101111101010111010111
1010100000100010000000100000101000100010001
1010111110101011111111111110101111101111101
1010100010101000001000100010101000100000101
1010101010101111101010101010101110111110101
1010001010101000100010101000101000000000101
1011111010101110111110101110101011111111101
1010000010000000001000100010001010000010001
1010111111111111101011101111111010111010111
1010100010001000101000101000000010100010001
1010101010111010101110101011111111101110101
1010001010001010100010001000001000100010101
1011101111101010111011111110101010111011101
1010001000000010101010100010100010001000101
1010101011111110101010101010111111101110101
1000101000000010000010001000000000100000101
1111111111111111111111111111111111111111111
