1111111111111111111111111111111111111111111
1000100000001000000010000010001010001000001
1011101110101111101010111010101010101111101
1000100010100000001000100010100010100000001
1110111010111111111111101110111110111111101
1000001010001000000000000010100000100010001
1011111011101110111111111010101111111010111
1000000010100010001000100000101000000010001
1011111110111011111010111111101110111011101
1010001000001000001010001000001000100010101
1010101011101111101011101011111011101110101
1000101010101010001010100010000010000000101
1111101010101010111110111110111011111110101
1000100010101010100000100000100010000010101
1010111110101010101010101111111110111011101
1010000010101010001010001000000010101010001
1011101010101011111011111011111010101010111
1000101010101010000010000010100010101000101
1110101010101010111010111110101110101111101
1010101000101010100010100000101000100000001
1010101111101010111110101010101011101111101
1000100000001010000000101010101000001010001
1011111111111011111111101010101111111010111
1000100000100000001000101010100000000010101
1110101110101111101010101011111011111110101
1010101000101000001010101000001010000000101
1010101011101011111011101111101010111111101
1010001010001010000000100000101000100000101
1011111010111011101110111011101111101110101
1000100010001000100010000010001000001010101
1010101111101110111011111110101111101010101
1010100000001010100000000010101000001010001
1110111111111010111110111110101011111011101
1000000000100010000010100000100010001000001
1011111110101011111011101111111110101011111
1010000000001000001010001000000000101010001
1010111110111111101010111111101111101010111
1010100010100010101010000010001000101010001
1011101011101010101011101010111110101011101
1010001000001010001000101010100010001000101
1010111111111011111110111010101011111110101
1000000000001000000000000010001000000000001
1111111111111111111111111111111111111111111
