1111111111111111111111111111111111111111111
1000100010101010001000000010101000100010001
1010101010101010111110111110101110111011101
1010001000001010001000000010100000000000001
1111101110111010111011111110111011111111111
1000001000000000000000101010100010000000001
1011111011111011111011101010111010111110101
1010000010100000001000001000000000101010101
1010111010111011101111101010111010101011101
1010100000001000100010000010001010000000101
1011101111111011111011101110101011101011111
1010000000101000001010000010101000101000001
1010101011101110111110101111111111111011101
1010101000000010000010100010000000100010001
1111111010101110101110101111101010101010111
1000000010100010101010100010001010101010101
1110101111101111101011101110111111111111101
1000100000100000100000100000000000100000101
1010111010101111111011101110111011111011101
1010100010100010100010000010001000000000101
1010101011101110111011111011101110111011101
1010101010000000100000001000101000001000001
1011111011111111101010101111111011101111101
1000100000000000101010100000101000101000001
1011101011101011111011111011101111111111101
1010001010001000100000001000100010000010101
1111101011101111101110111010101010111110111
1000101010001010000010001010001000000000001
1011101110111011101111111010111011111010101
1000100010101000000010000010101000101010101
1110101110101010101111111010101010101111111
1000000010001010100010101010001010100010101
1111101011101010111010101010101110101110101
1000001010001010001000001010100010000000001
1011101110111110101111101011101111101011111
1000100010001000100000101010100010001000001
1110111011111010111111101110101111101110111
1000001010100010100010000010001000100010001
1110111110111110101111111110101011111110111
1000100000001010000000000010100010100000001
1110101010111010111111101111101010111010111
1000101010000000000000101000001000100010001
1111111111111111111111111111111111111111111
