1111111111111111111111111111111111111111111
1000000000000000000000000000000000000000001
1011101011111010101111111011111111111110111
1000101000001010100000001010000000000000001
1011111110101010101010101011111010101110101
1000001000101010101010101010000010100010101
1010101110101011111010111011101110111110101
1010101000101010000010100000100010001000101
1010101110111110101010111011101011111010111
1010101000001000101010001010001000001010001
1010101110101110111110111011111110101110101
1010101000101000001000100010000000101000101
1010101110111111111010111011101011101111111
1010100010000000001010001000101010000000001
1010111110101111101011101111111110101110101
1010001000101000001010000000000010101000101
1011101111101110101011111110111110111011101
1010000000101000101010000000000010100000101
1111101011101011101110111011101111111111111
1000001000101010000010100000100000000000001
1010101010111111101010111110101010101010111
1010101010000000101010100000101010101010001
1010101111111010111011101111111010111010111
1010100010000010001010000010000010001010001
1011101011111011101011111110111110111011101
1010001010000000101000000010000010100010001
1010111011111110101111111010101011101111101
1010100000001000100010000010101000101000001
1011101111101110101010111110101010101010101
1010000000101000101010100000101010101010101
1110111110101010111111111010101110101111101
1000100000101010000000001010101000100010001
1011101011111111101010101011111110101010101
1000101010000000001010101000001000101010101
1110111111111010101010101110111110101111101
1000100000000010101010100010001000100000101
1010111110101111101011111011111010101011101
1010100000100000101000001010000010101000101
1111101010111111101011101111111010101010101
1000001010000000101010000000100010101010101
1010111011111011111011111110101111101010101
1010100010000000001000001000100010001010101
1111111111111111111111111111111111111111111
