1111111111111111111111111111111111111111111
1000101000001010100000001010001010001000001
1110101110111010101110101010111011101111101
1000100000001000100010101010000000000000001
1110111110111110101011111010111110101010111
1000101000000000001010100010101000101010001
1110101011101111101110111010101110101010111
1000000000100000100000001010000010101010001
1010101110111111101110111010101111111010111
1010100010001010001010000000100000101010001
1110111011101011101010101111101110101011101
1000001000100000101000100010000010001010101
1111111110101111111010101010111111111110111
1000100010100000001010101010001010100000001
1110111010111010101010101010101010111011101
1000000000001010101010101010100000100000101
1011101110111011111110111010101010101111111
1000101000001000101000101010101010001000101
1011111010111011101110101111111011101011101
1000100010101000000010000000101000100010001
1011111011101010101110101111101011101011101
1000100000100010101010100000001000101000001
1011111011101110111011101010101011101111101
1010100010001010000000101010101010000000101
1110111011111010111011111011111111101111101
1000100010001010101000100000000000100010101
1110111111101010101111111010101011101110111
1000001010000000000000001010101010000000001
1011101010111110111111111110111110101111111
1010100010001000000000000010001010100000001
1110101110111110101010101111101011101110111
1000000000001000101010100010101010101010001
1010101011111111101010101110111010111011111
1010101000000010001010100000000000000000001
1011111010111111101110101011101110111011111
1000100010000010100010101000100010100000001
1011111010111110101010111011111110111011101
1010100010100010001010100000000010001000101
1010101111111010111110111111101110111111111
1000100000100000001010000010001010101010101
1011101111111110111010101111111011101010101
1010000010000000001000100000000000000000001
1111111111111111111111111111111111111111111
