1111111111111111111111111111111111111111111
1000000000000000000000000000000000000000001
1011101110111110111011101011101111111110111
1010001000100000001000101010000000001000001
1010111111101011101011111011101111111111111
1010000000101000101000001010000000000000001
1010111111101110101111101110101111111111101
1010100000000010101000000010100010000000001
1011101010101010101010101011111110111010101
1000101010101010101010101010000000001010101
1011101110111011101010111110111110101111101
1010001000100000101010000010000010101000001
1110101111101111101010111110111010111111101
1000101000000000101010000010100010100000001
1110101011101110101110111110101110111011101
1000101010000010100010000010100010001000101
1011111011111011111010101010111010111011101
1010000010000000001010101010001010100000101
1011101111111111111110101110101011111011101
1010000010000000000000100010101000001000101
1011101011101010111111101011101110111010111
1000101000101010100000001010001000001010001
1011111110111010101110111011111011111011101
1000000010100010101000100000001000100000101
1111101110111110111111101111101110101110101
1000001000001000000010000010001000100010101
1110111011111110111110111111111111111011101
1000100000100000001000000000000000100000101
1111111010101011101110111111101111101011111
1000000010101000101000000010001000001000001
1010111011111010101011111110111011101110101
1010100000100010101000001000001010000010101
1010111011111010101110111111101110111010101
1010100000100010101000000000100010100010101
1010111110111111101010111011111110111110101
1010100000000010001010100010000000001000101
1110101011101111101010101011101010101010101
1000101010000010001010101000101010101010101
1110111010111110111111101011111110111011101
1000001010100000000000101000100000001000101
1011101010111111111010111011101111111110101
1000101010100000000010100010000000001000101
1111111111111111111111111111111111111111111
