1111111111111111111111111111111111111111111
1000000000000000000000000000000000000000001
1011101111111011101110111010111011101110111
1010000000001000100010001010100000101000001
1010101110101011101111101011111110101011101
1010101000101000100010001000001000101010001
1111101111111010101011101011101010101010101
1000000000001010101000101010001010101010101
1011101110111010111110111110101110101110101
1000100010100010100000000010100010100010101
1110101011111110111111111110111010101010111
1000101010000000000000100000001010101010001
1010101111111010111011101110111011101110111
1010100000001010100000101000001010001000001
1011111110101111101010111010111110111011101
1000000010101000001010100010000010001010001
1110111011111110111010101011101011101110101
1000100000100000100010101000101000101000101
1011111011111010111110101110101111111110101
1000001000100010100000101000101000000000101
1111111010111111111110111011101111111010111
1000000010000000100000100010001000000010001
1111101010111111101110101111101111101110101
1000001010000000101000101000000000101000101
1010111111111110111011101011111111101110101
1010100000000000001000101000000010000010101
1111101110111011111111111110111011111110111
1000000010100000000000100000100010000000001
1110101011101010111111101110111010111011111
1000101010001010000010000010100010100000001
1111101111101111111011101110111010101111101
1000000000100000100010000010100010100000101
1011111011111110101010111111101110111011111
1010000000000010101010100000000010001000001
1011101011101010111110101011101111101011101
1010001000101010100000101010001000001010001
1011101110101110101011101110111110111110101
1010001000101000101010000010100000000010101
1111101010111010111110111010111011111111101
1000001010100010100000001010100000000000101
1011101111101111101111111110101110101011111
1000101000000000100010000000100010101000001
1111111111111111111111111111111111111111111
