1111111111111111111111111111111111111111111
1000100000001000000000100000001000001000001
1110111111101011101011101111111110111110111
1000001000100010001000100010000010001000001
1011111110101111101011111010101110101011111
1000000010100010101000000010101000101000001
1011111010101110111011101010101110111110101
1000100010000000001010001000101000000000101
1111111011111011101111101011111010111011101
1000100010100010101000101000101010100010001
1011111010111010111010111011101010111011101
1000001000000000000010101000001010100010001
1111101011101111111111101111101111101010111
1000101010001000000000100000000010101010101
1010101011111011111111111011101110101110101
1010000000000000101010000000100000000010001
1111101111111110101010101111101011101111111
1000100010000010000010100000101000100000001
1110111010101110101110101010111011111011101
1000000000100010101010101010001010000010101
1111111010111110101011111110111111101010101
1000100010101000100010000010100010101010001
1010111110101111111110101111111010111011111
1010001000101000000010100010000000101010001
1010111011101110101010111010101111101011101
1010000000100010101010101000100000000000101
1010111110101111111011101011111111101011101
1010101010100010000000001010101000101000001
1110101011101111111110101010101110101110101
1010100010001000001000101000100000100010101
1010101111101011111011101011101111111011101
1000100010101000000000100010000010000000101
1011101110101111101010101110101010111011111
1000000000001000101010100010101010100000001
1011111110101011101111111011101111101110111
1010100010101000101000100000000000101000001
1010101010111110101011111111111011111110111
1010001010000010000010000000000010000010001
1110101011101111111111111111101110111110101
1000101000001010000010000010000000100010101
1111111110111010101111101110111011111010111
1000000000000000100010000000001000100000001
1111111111111111111111111111111111111111111
