1111111111111111111111111111111111111111111
1010001000101000101000001000001000101000001
1010101110101010101111101110101011101011101
1000101000001010001010100010100010000010101
1111101111101111101010101111101111111010111
1010000000001000000000000010000010100000101
1011101110111111111111111011111010111011101
1010001000100000000000001000000000000000001
1011111110111111101110111011101110101011111
1000000000000010101010100010001000101010001
1111111110111110111010111111111110111010111
1000001000000000000010101000001010100000001
1110111011101111101110101111101011111010111
1000001010100010000000000000100000000010001
1111101110111111101111111011111111101011111
1000000000000010001000100010100000001000001
1110111011101011111011111010111111111010111
1000100010001000000000100000100000001010101
1011111111111011111010111010111011111110101
1010000000001010001010000010100000001000001
1111111110101111101110111010111110111110101
1000000000100000001000100010001000000010101
1111111110101011101110111011101011101011101
1000001010101010101000100010000010101000001
1011101011101110101011111111111010101011101
1010000010001010001010000010000010001010001
1110101011111010101110111111101110111011101
1000101000000000100000000000001000100010101
1110101110111110111110111010111010111110101
1010101000001000100000100010001010001000001
1011111110111111111110111010111010111010111
1010100010100000000000001010101010101010001
1010111011111110101011101110101111101110101
1000100000000000101000101000001000000000101
1110111111111010101111111111101010101011111
1000000000000010101000001000101010101000001
1110111110111011111110111011111010111010111
1010100000001000100000000000000010100010001
1011101111111010111111101010111011111110111
1000001000000010100000001010100000100000001
1011101111101011111110101011101010101110101
1010000000101000000010101000101010101000101
1111111111111111111111111111111111111111111
