1111111111111111111111111111111111111111111
1000001000001000101010001000100000100000001
1011111110111110101010111110111110101111111
1000001000100000000000000010000000001000001
1011101011111110111011101011101011101011101
1010101000001000101010001000101000100000101
1110101110111010101111111011101011111110111
1000001000000010000000101010001010001000101
1110111110111111101111101111111011101011101
1010001000001000101000001010100000001000001
1010111011101010111011101010101011101111111
1000100010001010001000100010001010000000001
1110101111101111101010101111111011111011111
1000101000100000101010100010100010001010001
1110101011101111101110111010101011101010111
1000001000101010100000100000001000100010101
1010101110101010101110101111111011101110101
1010101000001000101000101000000000100010001
1110111111101011101010111111101011111110101
1000100000100000001010000010001000101010101
1110101111111010101011111111111011101010101
1000000000101010101010100000101000101010101
1111111010101111101110111011101010101010111
1010100010001000000000101000100010001000001
1010111111101011111011101011111010111010111
1000001000001010000010100010000010101010101
1011111111101010101010101011111110101011101
1010001010001010101000101000101000000000001
1010111011111010111111101010101010101111101
1010000000001010000010101010001010100010101
1011101010111111101010111111101011101110111
1000101010100000101000000010001000101000001
1011101110101110101011111110101111101011101
1010001010000010001010001000101010001010101
1011101011111110101111101011101010111110101
1000000000001000101000001010001000001000001
1111101111101111111010111111101110101011111
1010000010100000101010100010100010100000101
1011111010111110101011111010101111111011101
1000000010000000001000000010000010000000001
1011111011111010101111111011101111101110111
1000001000001010100000000000000000101000001
1111111111111111111111111111111111111111111
