1111111111111111111111111111111111111111111
1000100000001000000000001000001000100000001
1011101011101011111111101110101010101110111
1000001010001010000010000010101010101010001
1011111010111010111011111010101010101011101
1000101010000010101000001000101010000000101
1110101011111010101111101111111011111111101
1010101000100010001000101000000010001000001
1010101110111011101010101011111111101011111
1010000010001000101010101000000000101010001
1011111011101111101010101111111110101011101
1000100010001000001010100000001000101000101
1010101110111011111010111011111011101110101
1010100010000000100010001000001010000010101
1011111011111111101111101111101011101010101
1000001010000010001000000000001000001010101
1011101010111010111011111111111111111011101
1000100010100000100010000000100000001000001
1110111110111111111110111110101110111111101
1000100010100000000010001010100010000010001
1011101110101111111011101010111011111010111
1010000010101000001000100010000010001010101
1011111010101011111110111011111111101010101
1010000010000010000000001000100000001000101
1010101111111110111110111110101110111111101
1000101000000010001010100000101000100000101
1110111011111011101010101111101011101010101
1000100010000000001000101000001000001010001
1011101110111111111011101111111111111011101
1000101000100000100000100000000010001000101
1110101111101110101111111111111010101110101
1000100000100010100010000000001000100010101
1011111110111010111010111110111111111010111
1000100010001010001010100010000000001010001
1110111011101011101010101011111011111010101
1000100010100000101010101010001000000010101
1011101010111111101010101010101111111111101
1010001000100000001010101000100000100000001
1011101110101110111110111110111010101111101
1000001000100010100010100010100010101000001
1111111011111011101010101011101110101011111
1000000000001000001000001000001000001000001
1111111111111111111111111111111111111111111
