1111111111111111111111111111111111111111111
1000000000000000000000000000001000000000001
1111111111111111111111111111101111111110111
1000100010100010001010100010001000100000001
1010101110101010101010111010101011101010101
1010000000001000100000000000101000101010101
1111111110111111111111111111101010111110101
1010100000101000000000100000001010101010101
1010101011101011101011101111111110101010101
1010101000100010001000101010001000000010101
1010101111101010111011101010101110101110101
1010100000101010001000100000101000100000101
1010101111101111111111111110101011111111111
1010101000001000100000100000101000001010101
1010101010101010111011111011111011101010101
1010100010100010100000101010001000101000001
1010111011101011111010101011101110101111101
1010100000101000000010100000001000100000101
1010111110101010111010111011111110101110101
1000000000101010100010101000001000101000001
1111111111111111101111101111101111111111101
1000101000000000100010101010001000101000001
1011101011111010101010101011101010101010111
1000100000001010001010100000001010000010101
1011101011101110111010111110111011111010101
1000101010001000100010101010001000001010001
1011101011111010111010101010101110111111101
1000001000001010100000100000101000001000101
1111111111111111111011111111111110111011101
1000100010100010000000100000001010001000001
1011101010101010101110111011101010111110111
1000001000101000100010100010001000001000001
1011111110111111111110111010111011111111111
1000100000100010001010100010001010001010001
1011111011101111101010111011111011101010111
1000100000100010001010100000001010100010001
1111111011101111101010111010101010101010111
1010101010100010000010100010100000001000001
1010101010101011111010111110111011101111101
1000000000001000000010000000001010000010001
1011111010101110111110111010101011111010111
1010000010100010000000100010101010000010001
1111111111111111111111111111111111111111111
