1111111111111111111111111111111111111111111
1000001000001000000000000000100010000000101
1110111110111111101011101111111010101010101
1000101000001000101010100000100000101010101
1010101110111011111010101011111010111111101
1010000010100000100000101000101010101000101
1110101010101111111011111111101011101011101
1000101000100010001000001010100000000000101
1011111011111011101011111010111011111011101
1010101000101010100000000000000000101000001
1110101010101010111011101110111111101111101
1010101010101010100010101010100000000010001
1010101011101010101110101011101111111111101
1000000010100010100000101010100000001000101
1011111010111010101111111010101111111010111
1010101000100000000010000010000000001010001
1110101110111110111110111010111011111010111
1000101000101010001010101010001000000010101
1011101110101010111010101110111111111111101
1000101000000010000000001000100000001010101
1011101111101110111111101110111011111010101
1010100000101010100010100010000000100000101
1010101110101010101010101110101011101011101
1010101010101000001010101000101000001000101
1010101011101011101110111110111111111111101
1000000010100000100010001000000010000010001
1011101110101111111010111110101111101110111
1010000010101000001010100010100010100000001
1111101110101110111110111010111110101010111
1000001000000000000000000000000000001010001
1111101110111111101111111111111011111111111
1000000000001000001010101000100010100010001
1110111010111111101010101011111010111010111
1000001010001010001000000000001000000000001
1010101010101011111011111111111010111011101
1010101010100000000000000010000010001000101
1110111110101110101010101011111010111011111
1000101000101000101010101000100010001010101
1010101010101110101111111110101010111110101
1010100010101010100000100010101010000000001
1111111010111010101011101111101010101011101
1000000010000010101000000010001010101000101
1111111111111111111111111111111111111111111
