1111111111111111111111111111111111111111111
1000000000000000000000000000000000000000001
1010101110111110101110101110101011111110101
1010101000000010100010100010101010000000101
1110111111101110111111111110111111111110111
1000000000101000000000000010001000000000001
1011101111111111111010111110111110101110101
1010000010000000000010001000000010101000101
1010101011101010101111111110111110111110101
1010101000101010100000001000000010100000101
1111101111101110101011111111111010111011101
1000000010001000101000000000001010100000101
1010101111101111111010101011111010101010101
1010100010000010000010101000100010101010101
1011111011111110111010111110101110111011101
1000100000100000001010000010101000100010001
1110111011101110111110101011111010101110101
1000001010001000000010101000001010101000101
1010111010111011111111111110111010101110101
1010100010100000001000000000001010100010101
1110111110101010111111111110101111111110101
1000100000101010001000000000100000000010101
1110111011111011111011101111101011111010101
1000001000100000001000100000101010000010101
1011101111101011111110111010111111101111101
1000100000101000100000100010100000001000001
1011101110111010101110101110111011101110101
1010001000100010101000101000001010000010101
1110111111111010101110111010111111101011101
1000000000001010101000001010000010001010001
1011101110101111111110111110111111101010111
1010000010100000001000100000000000101010001
1011101011101011111111101011111110101110101
1000101000101000000010001000100000101000101
1010101010111111111111111010111011101010101
1010101010000000100000000010100000101010101
1011101111101111111011111110111011101110111
1000101000000000100010000000100000100010001
1011101111101011111110111010101010111111101
1000100010001000100000001010101010000010001
1011111010111011111110101110111010111011101
1000001010001010000000101000100010100000101
1111111111111111111111111111111111111111111
