1111111111111111111111111111111111111111111
1000000000000000000000000000000000000000001
1111101010111011111110101110111010101111101
1000001010100000001000100010001010100010001
1111101110101011101111101010111010111111101
1000000010101010001000001010100010000000101
1011101011101011101011101011101010101011101
1000101010001010001000101000101010101010001
1110101010101111111010101110101110101011101
1000101010100000100010101000100010101010001
1010111111111010111010101110111011101011101
1010000000100010001010101000100000101010001
1010111010111110101110101111101111101011111
1010001010000010101000100000100000101000001
1010101010111010101111111110111111111111101
1010101010100010101000000000000000000000101
1010111111101110101110101011101011111110111
1010100000001000100010101010001000100000001
1110111011101111101011111110101110101011101
1000001000100000101010000000101000101010001
1010111111101110111110111111101011101010101
1010000000100010100000000010001000101010101
1010101011111111101011111011101010101110101
1010101000100000001010000010001010101000101
1110101010101011101011111110111010111111111
1000101010101000101000001000100010000000001
1110111111101110111011101111111111101111111
1000100000001000100000101000000000000000001
1011111011111111111110101111101010101011101
1000100000000000000010101000001010101010001
1010111110111111101010111110111010101110101
1010001000100000001010001000001010101000101
1110101111101010101011111111111110101010101
1000100010001010101010000000000000101010101
1011101011111110101010111011111010101110101
1000101000100000101010001010000010101000101
1010111010101110101110101011111110111010101
1010100010100010101000101000000010100010101
1010111110111110101011111010101011111011101
1010100000000010101010000010101000001010001
1110101111101011101110111110111011101110101
1000100010001010001000100000001000101000101
1111111111111111111111111111111111111111111
