1111111111111111111111111111111111111111111
1000000000000000000010000000000000000010001
1011111111101011101010101011101111111110111
1000000010001000101010101000101010100010001
1110111111111111101010111111101010101010111
1010100010000010001010001000100000001010001
1010111011111010101011101110101111111111101
1000100010000000101000101000100010100010001
1011101110101010111010101011101010101110111
1000000010101010001010000000101000001010001
1011101110111110101011111110111110101010111
1000100010001010101010100000100000100010001
1011111110111010111010101110111110111110111
1000000010000010001010001000100000000000001
1111111111111110111011111111111111111111111
1000000000000000001010000010000000001000001
1011101110111111111011101110101110111110111
1000101000100000001010000010101010100000001
1111101010101110111010111010111010101010101
1000001010100010001000001010001000001010101
1111101110111011101011101111101011111111101
1000001000000010001010101010101000001000001
1010101111111010111010101010101011111011111
1010101000000010001010000000001000001000001
1111101010101010111111111111111111111011111
1000001010101010001000000010100010100010001
1111111111111110111010111010111010111011101
1010101010100010001010100010000010100010001
1010101010111010111010101111111010111010111
1000001000101000101010100010100000100000001
1111101010101010101111101110101010111011101
1000000010000010001010100010001010100010001
1111111111111111101010101110111010101110111
1000000000000000001000000010001010100010001
1111111111101111111111101111101110101010111
1010000000100000101000000000000010101010001
1010111011101010101111111011101110111011101
1000100000101010001000000010000010000010001
1010101110111110101111111011111111111011101
1010100010100000101010001010000000101010001
1010111110111110101010101011101010101011101
1010100000000000101000100000001010100010001
1111111111111111111111111111111111111111111
