1111111111111111111111111111111111111111111
1000001010000000001000100000000000000010001
1011101010101111111010101111111111101011101
1010001000100000000010001000000010001000001
1010111111111110111110111110111010111111111
1010000000000000100000100010001010001010001
1110111111111111101111101011101011101010101
1000100000000000101000101000101000001000101
1011111111111110101110101110111111111111101
1010000000001010001000100010000010001000101
1010111011101010111011101011101110101010101
1000100010100010000010001010001000100010101
1111101010101111111110111110111011111110101
1000001010100010100010100000001000001000101
1011111010111010101110101111101110111011101
1010100010100010101000100010000010100010101
1010101110101110101010111110111010101110101
1010001000100000100010100010001010101000001
1011111011111011111010101011101110101011111
1010000010000010001010101000101000100010001
1010111111111110101010101110101010111110111
1010000000000000100010100010101010100010001
1011111011111111111111111011101010101011101
1010000010100000100000000010001010001000001
1010111110101110101110111110111011111110101
1000001000100010100010100000000010000010101
1111101010111010111011101111111110111110101
1000101010100010100010001000000000101000101
1010101110101110101110111011111111101011101
1010001000101000100000100010001000000010001
1011101011101011111111101010111011111110111
1010100010001000000010001010100000101000101
1010111111111111111010111010101110101010101
1010001000000000001010001000101000100010101
1011101010111110111011111110101011111110101
1010101010000010001000100000101010000000101
1010101010111111101110101111111010111111101
1000000010100000001000100010000010001000101
1111111111101111101011101010111111111010101
1000100010001000101010001010001000100010101
1011101010111011101010101111101010101110101
1000001000001000001000100000000010001000001
1111111111111111111111111111111111111111111
