1111111111111111111111111111111111111111111
1000000000000000000000000000000000000000001
1110101010111110111011101110101011111110111
1000101010000010100000100010101010000000001
1111111010101010101010111011101111101111111
1000000010101010101010001010001000000000001
1010111010101011101111111010101010111110111
1010100010101000100000001010101010000010001
1011101111101110101010111111101011111011101
1010001000001000101010000000101010000000101
1011111111111010101010101011101011101111101
1000001000000010101010101000101010001000001
1010101010101010111110101010101010101110101
1010101010101010100000101010101010101000101
1111101011101110111110101011101110101011101
1000001010000010100000101000100010101010001
1011101111101010101011101010101011101111101
1000101000001010101000101010101000101000001
1111111010111011111011111111111011101111101
1000000010001010000000000000100000100000101
1011101010101110111010101111101110111010111
1010001010100010100010101000001000100010001
1011111010111110111011101111101111101111111
1010000010100000001010000000100000100000001
1110111111111110111111111010111011101010101
1000000000000010100000000010100010001010101
1011101111101011111110111010101010101110111
1010000010001000001000100010101010101000001
1111101011101010101110101010111110101011101
1000001000101010100010101010100000101010001
1011101010111111111011101111101111101111111
1010001010000000100010000010000010000000001
1011101110111110111111101110111110101010101
1010000010100000001000000010000010101010101
1011111110101110101011111010111111111010111
1000000010101000101000001010000000001010001
1011101010111010101110101010101110101011101
1010001010001010100010101010101000101010001
1010101010111111101111101111101111111110111
1010101010100000000000100000101000000000001
1110111011101111101111101111101011111110111
1000100010001000000000100000101000000010001
1111111111111111111111111111111111111111111
