1111111111111111111111111111111111111111111
1000000000000000000000000000000000000000001
1010111111111011111011111010101111111111101
1010001000000000001000001010100000000010001
1111111011101111111111101010111011101111101
1000000000101000000000001010100010001000001
1011101111111010111110111011111010101011101
1000100000001010000010100010000010101000101
1111101110101110111110101010101111111110101
1000001000101000001000101010100000000010101
1110101011111111101111111010101011101110111
1000101010000000000000001010101010001000001
1110101010101010101110111111111010101011101
1000101010101010101000001000000010101000101
1110111011101011111110111111111010111011101
1000001010001000100000001000000010100010001
1110111010101011111011111011111011101111101
1000001010101010000000001000100010000010001
1011101011101010111011101111111110111011101
1010001010001010100010000000001000100000101
1011111010111011111011111011111111101011101
1000100010001000001000001010000000001010001
1011101111101111111111111010101111111111111
1010000010001000000000000010100000000000001
1011101111101011111010111011101111111010101
1000100010001000001010001010000010000010101
1110101110111010101010101011101011101111111
1000101000001010101010101000101000100000001
1010111111111010101110111011111011101011111
1010001000000010100010001000001010001000001
1011101011111011101011101010101110101111101
1010001000100010001010001010100010100000101
1010111010101010101111111011111111101010111
1010100010101010101000000000001000001010001
1010111111111010111110101110111011111010101
1010100000000010100000101000001010000010101
1110101010111010101010111110101010111110111
1000101010001010101010100000101010100000001
1011111110111011101111101010111011101010101
1000100000100010000000101010100010001010101
1110101111111011111110101110111011101010111
1000100000001000001000101000100010001010001
1111111111111111111111111111111111111111111
