1111111111111111111111111111111111111111111
1000000000000000000000000000000000000000001
1010111111101111111111111011111111111011101
1010001000000000000010000000001000000010001
1010101111101011111110111111101011101111111
1010101000001000100000100000001000100000001
1011101011101110111110101110111110101110101
1010001010000010001000100010000010100010101
1111101010101110101110101010111010111111101
1000001010101000101000101010001010000010001
1011111111101111111110111011101111101111101
1010000000001000000000100010001000000010001
1111101011111011101011111110111110101110101
1000001000001000101000100000100000101000101
1011101110111011111111111011101110111011101
1010001000100000000000100010000010100000101
1110101110101110101010101110111110111010111
1000101000100010101010100010000010100010001
1011101111111111101010101011111011101011101
1010000000001000001010101010000000101010001
1110101110111011101110111011111011111110111
1000101000100000101000100000001000001000001
1011111011101111101111111110101110101011111
1010000000100000101000000000101000101000001
1111101011111011101011111111111010111011101
1000001000100010001010000000000010001000101
1011111110111111101010101011101111101110101
1000001000100000001010101000101000000010101
1110101111101110111011101111101010101010101
1000101000001000100010000010001010101010101
1011111010111010111110111111111011101010101
1000001010001010100000001000000010001010101
1011111110101010111011111011111111101011101
1000100000101010100000100000100000001000101
1111111011101011111011111111101110111111101
1000000010001010000000000000101000000000101
1010101111101110111111101111101011111111111
1010100000100010100000000010001000000000001
1111101011101110101010101011111010111010101
1000001010001000101010101010000010100010101
1011111011101010101010101011101110111110111
1000100010001010101010101000100010100000001
1111111111111111111111111111111111111111111
