1111111111111111111111111111111111111111111
1000000000000000000000000000000000000000001
1011111111111011111011101111101110111010101
1010000000000000100010000000101000001010101
1010111111111111111111101010111110101110101
1010000000000000000010001010100000101000101
1111101111101111111011101110111010101010101
1000000010001000000010001000001010101010101
1010111110111110101010111110101011111110101
1010001000001000101010000010101000100000101
1010111010111010111011101011111010111011101
1010001010100010100010001000100010100000101
1011111110101111111010111111101110111111101
1010000000101000000010100000001000000000101
1110111011111111111010101010101111101011101
1000100000000010000010101010100000101010001
1011101011111111101111101010111110111110101
1000101000000000100000101010000010001000101
1010111111101111101011101111101111111011101
1010000010000000101010001000000010000000101
1111101111111010101011101010111010101011101
1000000000001010101010001010100010101010001
1011101011111110111110111011111011101110101
1000101000001000100000001000100010000010101
1010111011111110111011101010101111111011101
1010100000001000100010001010100000001010001
1110101111111011111010101111111111111011101
1000101000000000001010100010000000000000101
1011111111111011111010111011111110111010101
1000100000000000001010001000100000100010101
1010111111101111101110101011101011101010101
1010001000001000001000101000101010001010101
1110101110111010111110101110101010101110111
1000100010001010000010101000101010101000001
1010111111101011101011101111101110101010111
1010000010001010001000100000100010101010001
1011111010111011111110111010111011111011101
1010000010100000000010001010001000100000101
1011101111111110111011111110111111101110101
1000101000000000001000000010100000001000101
1011101111101010101110111010111010101011101
1000100000101010101000001010001010101000101
1111111111111111111111111111111111111111111
