1111111111111111111111111111111111111111111
1000001000000000000000100000000000100000001
1011101011111111111110101111111110101111101
1010001010001000001000001000001000101000101
1010111010101111101011111011101011101010101
1010100010100000101000101000101000101010001
1010101110111010101110101010101010111011111
1010100010001010001000100010100010001000001
1010111011111010111011111110111111101011101
1010001000001010101000100010000000101010001
1011111011101010101010111011101110101011111
1010001010000010001010001000100010101010001
1010101011111111111011101110111110101010101
1000101000001000000010001000000010101000101
1111101111101111111110101111111010101111101
1000100000100010001000101000001010100000101
1110111110111010101011111011101010101110101
1000100010100010101010000010001000100010001
1010111010101110101010111111111111111011111
1010000010000000101000100000000000000010001
1010111111111111111011111110111111111110101
1010000010000000001010000000100010001000101
1011111110111110101010111111111010111011101
1000000010001000101010000010000010100010101
1111111011111111101011111010111110101110101
1000001000100000001000001010000000101010001
1011101011101111111111101011101111101011101
1000101000001000100000001000100000101000001
1011101011111010111010111110101110101011111
1010001000000010001010100010001010001000001
1110111111111110101010101011111010111011101
1000001000001000100010101010001000101010101
1011111011101011111111101011101110101010101
1010000010101010001000001000100010101000101
1010111110101010111011111110101010101110101
1000101000001010000010001000001010100000101
1110101011101011101110101011111110111111111
1000101010001000101000100010000010001000001
1011101010111110101011111111111011101011101
1000001010001010101000000000000010100010101
1011111011101010101111111111111010111110101
1000001000100000100000000000001000000000001
1111111111111111111111111111111111111111111
