1111111111111111111111111111111111111111111
1000100010000010000000101000001010000000101
1110101011111011101111101010101010101110101
1000001010000010101000100010101000101000101
1111101111101010101010101110111111101110101
1010100010001010000010101000001000101000101
1010101010111110111111111110111011101011101
1010001010000010001000100000000000001000001
1011101111101110111011111111111111111110111
1000001000001010000000100000000000000000001
1010101010101011101111111110101010111111101
1010100010100000000000101000101010100010001
1111101111111111111111101010101110101110111
1010100010001000100010100010101000100010001
1010101110111110111010111011111110101111101
1010000010000000100010101000101000101010001
1010101110111110101110101110101110101010111
1010100000001000000000100000101000100000001
1011111111111111101111101010101011101111111
1010000010000000000000101010001000100000001
1011111011111111101111101111111111111110111
1010000010001010101000000000000000100000001
1010111110111010101010111110111111111111111
1010001010001010000010101010101000100010101
1010111010111010101110101010101010101010101
1010000010001010100010100000100010001010101
1011101111101011101111101110101111101110101
1010000010000000000000101000001010001000101
1010111111111011111111111111101010111010101
1010101000000010001000100010001000000010101
1010101011111010101010101110111111111010101
1000000010100000100010100000001000000010001
1011101110101010111011111111111111111110111
1010000010001010100000101000100000000000001
1111111011111111111111101011101110111011101
1000000000000000000000100000000010001000101
1111111111111111111111111111111111111011111
1000001000000000100010101000100000100000001
1011111010101010111010101011101110101111101
1010100010101010100010101000000010001000001
1010101011111110101110101110111010111010101
1000001000100000000000000000100010001010101
1111111111111111111111111111111111111111111
