1111111111111111111111111111111111111111111
1010000010000000100010001010000010100000001
1010111011101111111011101010111010101010101
1010001010000000100010100010001000101010101
1010111110111111101110101011101110101111111
1010000010001010100010001010001000000000101
1010101010111010101110111110111110111010101
1010101000000000100010000000001000100010101
1011101110111010111011111011101111111011101
1000001010001010100000000010000000100000001
1010101011111011101111111010111010111110111
1010100010000000000010000010100010100000001
1111111111111111111111111111111111111111101
1000000000000000000000000010000000000010001
1111101111111111111111111111111110111111101
1000001000001000000000001010000000000010001
1111101111101110101111101010111111111110111
1000001000000010100000100010000000101010001
1011111011101010111010101011101111101011101
1000101010001000100010101010000010101010001
1010101011101110111011101010111010101010111
1010000010001000100000101010001010000010001
1011111111111111111111111111101110101011101
1000000000000000000000001000000010101010001
1111101111111111111110101011101110101011101
1000100000000000100010100010000000101010001
1010101111111110101110111111111011111110111
1010100010101010100010000010000000100010001
1010101110101010111011111010101010111010111
1010100000001000100010101010101010100010101
1010101110111011111010101011101111101110101
1010100010001000100010000010000010100010001
1010101110111011111010111110111110111010111
1010000010001000100010000010101010001010101
1111101111111111101110111010101010101010101
1000100000001000101010001010000000100000001
1110111011101011101010111011101111111111101
1000000010001000100010001010000000100010001
1011111010111110111010111110111110111011101
1000100010000000001010100010001000000010001
1010101111101011101010101011101110101011101
1010100010001000100010001010001000101010001
1111111111111111111111111111111111111111111
