1111111111111111111111111111111111111111111
1000000000101000000000100010000000000000001
1111101110101010111111101010111110111111101
1000101010100010000010001000100010000000101
1010101010101111111010111111101011111110101
1010101010100010001010100000101010000010101
1010101010101110101010101011101010111010101
1010001010101000100010001010001000100010101
1011111010111011111010111110111011111010101
1010001010100010000010100000100010001010101
1010101010101011111110101111101111101011101
1000101000001010000000100000100000101010001
1111101111111110111111111110101111101010111
1000001000001000100000000010101000101010101
1011101011101011101011111110111010101010101
1000101000101000101000100010000010001000101
1110111110101110111010101011111111111111101
1000100000100010001010001010000000101000001
1011101111101111101111101010101110101010101
1000001010001000100000101010100010001010101
1011111010111010111110101010111011101010111
1000100010000010001000101000001000101010001
1110101011111111101011111111111110101011101
1000101010000010001000100000001000101010001
1011101110111010111110101111101011111010111
1010000000100010000010101010001000100010001
1011101111101111101110101010111110101111101
1000100010100000100000101000000010001000101
1110111010111011111111101111111011111010101
1010001000001000000000100000100000000010001
1011101011111111101011101110111111111111101
1000101010000000101000101000100010000010001
1010101010111110101110101010101010111010111
1010001010001000100010001010101010001010001
1011111011101011111111101011101011101011101
1010000010001000000000101000001010001000101
1010111110111111111110111111111010111110101
1010001010000010000010100000001010001000101
1011101011111010111010101111101011101110101
1010000010001000001010101000101000100010101
1011111110101111111010101011101110101011101
1000000000100000000010001000000000101000001
1111111111111111111111111111111111111111111
