1111111111111111111111111111111111111111111
1010001010001000101010100010100000100000101
1010111010101110101010101110101110111010101
1010000000100000100000000000000010101010001
1011101111101011101010111110101111101010111
1010001010001000001010100010100000100010001
1010111010101111101110101110101111101111101
1010001000101000000010100000100000000010001
1011111111111111101111111111111111111111111
1010101010101010100000100000001000001010001
1010101010101010101011111110111010101011101
1000000000000000101000100000001010100000001
1011101111111111111110101111111010111010111
1010000000001000001010000000001010001010001
1011111011111011101010101111111111101010111
1010001000101000100000100010001000001010001
1010111010101110111110111010111111101010111
1010001010001000100000100010000000101010001
1011101110101011101011101110111010101010111
1010000000101000101000100000001010001010001
1010111010101011101011111111111111111110111
1010001010100000101000100010101010001000001
1011111111101111111111101010101010101011111
1010100010000000000010101010000000101000101
1010101011111011111110111011101010101010101
1010001010001000000010100000001010100010001
1010111111101011111110111111111110111011111
1010000010001000001010100010001000100000001
1011101110111011101010101010111011111011111
1010000010001000101010101010001000100010001
1010101010111111101010101011101011101010101
1010101000001000000010101000000000101000101
1011111011101111101010111111111011111011111
1010001010000000001000100000001000101000001
1010111011111111111110101010111110101110101
1010000010000010000010101010001000100000101
1011111010111010111010101111101010101011111
1010000010100000100000101000000010101000001
1011101111111110111111111011111111111111111
1010000010000000100000100000101010100000101
1011111010101011101010101110101010111010101
1010000010101000001010101000000000000010001
1111111111111111111111111111111111111111111
