1111111111111111111111111111111111111111111
1000101000101000001010100000001010001010101
1011101011101011101010101011111011101010101
1000000010001010000010101010101010000000001
1110111110111111101010101110101010111011101
1000001000100000001010001010001010001010101
1011111011111111101110101011101010111010111
1000001010100010000000100010000000101000001
1011111010101111101011111111101110101111111
1000100010100000101010100000000010000010001
1011101110101011101110111011111111111111101
1000000010101010101000000000000000100010101
1111101110111010101011111110111010111010101
1010101010000010000010000010001010101010001
1010101011101111101110101111111111101011101
1000001000000010100000101010001000101000001
1110101111101010101010101010101010101110111
1000100000101010001010101000101010100010101
1011101111111011101111101110111011111010101
1010001000100000100000101010000000001010101
1011111011111110101111111010111111111010101
1010100000101010001010100010101000100000001
1010111011101011101010111010101010111010101
1000100010101010001000101010100010000010101
1110101110101010111011101010101010111111111
1010101000001000101000101010001010101010101
1010101111101011101011101011101011101010101
1010101000000010000000000000001000000000101
1010101110111011101111111011111110111011101
1000100010101000001000001000000010001000001
1010101111101110101011111110101011111010111
1010001010101010100000000010101010000010001
1111101010101010111111111010111111111011111
1000000000000000001000001010000000001000001
1011101111101110111011111111101010101010101
1010001010000010001000000000101010101010101
1111111010101111111011101111111111111111101
1010001010100000000000101000000000100010001
1011101011101111111111111110111011101111111
1010100000000000000000000000001000100000001
1010101110101010101010101111111011101111111
1000000010101010101010100000001000000000001
1111111111111111111111111111111111111111111
