1111111111111111111111111111111111111111111
1000000000101000000010001000000000100010001
1110101010101111101111101011101110111010111
1000101010001010000010001000101000100010001
1110101111101010101010111111101110101010101
1000100010001000101010001000001000001000101
1010101111101010111111101011111111111111111
1010100010000010101010001010101000000010001
1111111011111010101010111010101110101011101
1010001000001010000010001010000000101010001
1011101010101111111011101011111011111011101
1010000010101000000010001010001000001010001
1011101010101110101011101010111110111011101
1000001010101000101010001010100000001010001
1111101111111110111110111010101010101011101
1010000000001000001010000010001010101010001
1011101110111010101010101011101110101010111
1010001000101010100010101000001000101000001
1010101011101110111011101111111011111111101
1000101000001000001010001000100000000010001
1011111111111011101011101011111010101011101
1000001010001000101010001000000010101010001
1010101011101111101111111111101111111111111
1010101000001000100010100000000000000000001
1011101010101011111010111010101011111011111
1010000010101000100010100010101000100010001
1110111111111010111010111011101110101111101
1000000000001010100010000010001000100000001
1011101110101011101110101110111110111010111
1000101000101000000000100010001000100010001
1111111111101111111111111111111111111110111
1000100010101000000000101010000000000000101
1010111010101111111010101011111011111010101
1010000010001000000010100000000000001010001
1011111011101011111010101010101010111111101
1000100010001010101010001010101010001000001
1111111010111010101010101010111111101010101
1010101000001000001010101010001000001010101
1010101010111110111111101011101111101110111
1000000010001000000010101010001000001010001
1111111111101011101010101011111110111010101
1000000000001000101000101010000000001000101
1111111111111111111111111111111111111111111
