1111111111111111111111111111111111111111111
1000100000001000000010000010000000000010001
1011101111101011111011111010111111111010101
1010001000101010000000100010100010000010101
1010111010101010111110101110101110111110111
1000100010001010001010100000100010100000001
1111101111111111101010101111111010111111101
1000000000000000001000100000000010000000001
1011111111111110111111111111111110111111111
1000001000000010100010000010000010001000101
1111101011111010111010111010111011101010101
1000100010000010000010001010001000001010101
1011111011111111111110101110101111111110101
1000001000100000000010100000100010000010001
1111101010111110111010111111111010111011101
1000001010000010100010100010000010100010001
1011101111101010101110101010111110101110111
1010100000101000100010101010000000101010001
1010111011101111111010101111111111101010101
1010001000100000001000100000100010001000101
1010101110101111111111111110101010111110101
1010100010100010000010000010101000000000101
1010111110111010101010111010101111111111111
1000100010001000101010001000100000000000001
1111101011101011111011101111101111111111101
1000101000101010000010000000100000100000101
1011101110101010101110111110111110111110101
1000001000101010101010100000100010000010101
1111101110101110101010111111101011111010101
1000001000100000100010001000101000000010101
1011111011111111111011101010111111111110101
1000001010000000101000001010000010000000001
1111101010111110101111111010111010111111111
1000101000100000000000001010001000100010001
1010101111101111111110111011111111101110101
1010101000001000100000001000000000000000101
1010111011111110111111101111101111111111101
1010100000000010100000101000100000100000001
1010101111111010101111101010111110111111111
1010001000000000001000100010100010000010001
1011111111111111111010111010101011111010101
1000000000000000000010001010001000000000101
1111111111111111111111111111111111111111111
