1111111111111111111111111111111111111111111
1000100010100010101000100000001000001000001
1010101110111010101110101111111011101011101
1010100000000000101000100010000000101010001
1110101111111111101011101010111111111011111
1010001000100010000000101000000000100010001
1011101110101110111110101110111010101110111
1000101000100010100000001000100010000000001
1011101010101010111110111111101111111110111
1000000010101000001000101010100000100000001
1110101111111011101011101010101011111010111
1000100000100010101010100000001010000010101
1110101010111010101010101111101111111011101
1000101010001000101010000010000010100000001
1110111110111011111110111110101010111010111
1000101000100000100000001000101010000010101
1010101110111111101110111111111011111110101
1010001000101000001000100000000010100010001
1010101111101110101011111110111010111010111
1010100000000000101000100000101000101010101
1110111111111110101011111110101111101010101
1010001010100000101000000010001000000000001
1010111010101111111010111010111111101111101
1010000000100000001010100010101010001000101
1011101111111011111010101011101011101010111
1000000000001010001010101010001000001010101
1110111010111111101111111110101010101011101
1010100010001000100000001000100010100000001
1010101110101011111011101110111111101011101
1010100010100000100010000010001000001000101
1011101110111011111011111111111111101111101
1000001000101010000010000010000010001000101
1111111111101010101111111011101111101110101
1000000000101000100000100000001000001000101
1010111011101011111011101111111111111011101
1010100000000000001000001010000010000000001
1011111111101111111011111010101110101010111
1010000000100010101000000010100000101010001
1110111010101010101011101011111111101111101
1010001010001010000000101010100000000010001
1011111011111110111110111110111110101111101
1000000000100000001000100000000000101000001
1111111111111111111111111111111111111111111
