1111111111111111111111111111111111111111111
1010000010101000000000000010000000100000001
1011111010101110111010111111101110111011101
1010000000100000001010100010100010100010101
1011111110111011111110111010111010111110101
1000000000000000100010101010001010001000101
1011111010111111111010101010111110111110101
1000100010101000000000000000101010100010101
1111111111101010101111111110101010111010101
1000000010100010100000100000000010000010101
1111111010111111101111111111101111101110101
1000001000100000000010000000001000101000101
1111101011111110111111111111101110101011101
1010000000000010100000000000000000000000001
1011101110111111111110101111101010101110101
1000001000100000000000101000001010101000101
1111111110111010111011111110111110111110101
1010001010000010001010000000100010100000101
1010111010101110111111101110111010111011101
1000000000101010001010101000101000001010101
1010111110111011111010111110101110111110101
1010100000001010000000101000100000100000001
1111111110111010111011101111101010111011101
1000000000100010100000100010001010100010001
1110111110111011111011111010111011111011101
1000101000001000000000000000100010000010001
1110101110111111111110111011101111111111101
1000000010100000000000101000101000100000001
1110101011101110111010101011101011101010101
1000101010001000001010001010000010001010101
1011101111111110111110111111101011101110101
1010001000001000101010100000001000100010101
1110101111101111101010111110111010111110111
1000100010000000000000001000001010100000001
1010101111101110101110101110101010101110111
1010101000000010101000100010101010101000001
1110111110101011101110111010101011111011101
1000100000101010001010101010101010001010001
1010101011101111101010101011111110111010101
1010101010001010000010100010000010000010101
1111111110101011101111101111101110101010101
1000000000101000000010000010000000101010101
1111111111111111111111111111111111111111111
