1111111111111111111111111111111111111111111
1000000000000010000000001000000010001000001
1011101111111010111011111010111010101111101
1010001000000010101010000010100000100010001
1110111011111110101010111110111111111010101
1000100000001000101010100010000010001010101
1011111110111011101010101011111010101010111
1000001010100010001010001010001000101010001
1011101010101111101011111010111111101011101
1000101000100010001000001010000010001000001
1111101011111010101110101010111010111111101
1000001000001010100010101010100010001000001
1011111111101010111110111011101011101011111
1010000010001000100000100010001010001010001
1010101110111110101111101110111110111011101
1010100000000010101000100000100010100000001
1010111111111110101010111011101010111111101
1010100010000000100010001010001010001000001
1011101010111111111111101010111011101110111
1010001010100010000000100010001000100010101
1010111010101110101110111110101110101010101
1010101000100000101010100010100010101010001
1010101111101111101010101110111010111011111
1010100000101000101000100010001010001000001
1010101111101110101011111011111011101111101
1000100000101000101010001000000010100000001
1011111110101011101011101111111110111111111
1000000010101010001000101000100000100000001
1111111010101010111110101010101010111011101
1000001010001010001000001010001010000010101
1011101010111011101111111011111011111110101
1000101010100000100000000000001000001010001
1110111010111010111111111111111011101010111
1000100010001010001000101000001010001000001
1010101111101011101010101011101110111111111
1010101000001010001010001010100010001000001
1010101110111010111010111010111010101011101
1010100010000010000010100010000010100000101
1011111011111111111011101110111110111111101
1000001010000010001010001010100010100000101
1011101010111010101110111010101011101110101
1000100000100000100000100000001000001000001
1111111111111111111111111111111111111111111
