1111111111111111111111111111111111111111111
1010100000100010000010101000001000001000001
1010111110111011101110101111101110111110101
1000000010100000001010100010001010001000101
1110111010111110101010111010101010101110111
1000100010000000101010100010100000101010101
1110111011111111101010101011101011111010101
1000101010001000001010101000101010100000001
1111101011101110101010111011101110111011101
1000000000101010100000001010001000101000101
1010111011101011111111101011101110101011111
1010101000101000001000000010001010000000101
1010101010101110111111101011101010111111101
1010100010000000000010101000000000001010001
1111111010101111101110111111101111111011101
1000000010100010100000000000001000101000001
1011111011111110111110101111101110101011111
1010000010001000001000100010001000001010001
1111111111101011101110111111101011111010101
1000101010001010000010100000000010001000101
1010101011101111101011111010111010111010111
1010000000000010101000100010001000001010101
1111111011101110111110111111111011111011101
1000100000100000000000101000001000001010001
1011111011101111111110101110101110111010111
1000000010001010001010001000101000001000101
1110101110111011101010101111101110111110101
1000101010100010100010100010000010100000101
1110101011111010101011111011101110111011101
1010101000100010101000001000101000101010101
1011111011111010101111101011101110101010101
1010000000100000001000000000100000000000001
1011111110111111111011101010101010101010111
1000000000001000000010001010001010101010001
1011111111101110111111111110111111101110111
1010001010000000101000000000000000100010001
1111101011101110101011101111111111111111101
1000000000000010100010101000100000000000001
1111101110101111101010101110111010101011101
1010000010101000001010001010000010101010001
1011101110111111111011101010111010101011101
1000000010100000000000100010001010101010001
1111111111111111111111111111111111111111111
