1111111111111111111111111111111111111111111
1010001000001000001000100010100000101010101
1011101011101111101110101010101010101010101
1010001000101010000000101000001010101000101
1010111111101011101011111011101110101011101
1000001000001010001000101010100010001000101
1110111110101011101011101010111110101011101
1000001000100000001000100000100000100000101
1011111111111110111111101110111110111011101
1000001000000000000000101000100000001000101
1110111110111010101010101111111111111010101
1000001010001010101010101000100000001010101
1010101010111110111110101110101110101011101
1010101000001010001000100000101000101000101
1011111110111010111110101011101110101110101
1000101000001010001000101000001000101000101
1110101110111011101110111111111111111011101
1000001000001000001000101010100010001010101
1111101111111111101111101010101010111010101
1000000000000000000000000000001000000000101
1011111111111111111111111111101111111111101
1000001010101010000010000000001000100000101
1110111010101011101010101111101110111110101
1000101000100010101000100010001000100000001
1110101011111010101010111010101011101110101
1000001000000010001010100010101000001000101
1111101011111111111111111111101110111110101
1000001000000010100000100010101000100000101
1111101111101110101111111010101010101111101
1000001000001010100000100000001010100000101
1011101010111010111110111111101011111011101
1000101010000000101000001000101000100010101
1110111011101010101011101011101011101010101
1010001010001010000000101000001010101000101
1010101111101110101110101011101010111110101
1000101000000010101000100000100000100000101
1110111111111111111111111111111111111111101
1000100000100010101010000010000010000000101
1011101010111010101010111010111010101110101
1010101010000000001000100000100000100010101
1010101010111110111110101110111011101110101
1000001010000010000000100010100010000010101
1111111111111111111111111111111111111111111
