1111111111111111111111111111111111111111111
1000000010000000100010000000100010000000101
1111111010111111101011111011101110101011101
1000101000100000101010000010000010101000001
1011101110101010111010111110111110111111101
1000001000001010101000000000000010100000101
1110101111101111101111101011101110111011111
1000101000101010100000101000100000100000001
1011111010101010101011111111101111101010111
1000101010100010001000000000101010101010101
1110101010111011111011111111101010101111101
1000000010100000101000101000000000000010001
1111111110111110101110101111111111101010111
1000001010001000000000001000001000001000001
1011101010101111111110111011111111111010101
1010000000101010001000000000000010100010101
1110111111101010101011111111111010111010111
1000100000001000101010101000100010001010101
1111111010111111101010101110101110101010101
1000100010000010000010000000000000101010101
1011111110111011111010111110111111111011101
1000001000001010000010001000001000000000001
1110101010111110111110111010111110111111111
1000100010000000101000100010100000001010001
1110101111111110101011111011111110111011101
1000101000001010100000100000101010100000101
1010101110111011111110101110101010101110101
1010100010000000100010101000100010000010001
1110111110111110101011101110101011111110101
1000001000100000101000001000101010001000101
1010111011111011111011101011111010111111101
1010101010000000000000101000000000101000001
1111101011101110101111101110111011101011111
1010101000100010101000100010100000000000001
1010101010111111111011101011111110101110101
1000000010100000100010001000001010101000101
1110101111111010101011111010111011101111101
1010100010000010001000101010101000000000101
1011101111101111101010101111101110111010101
1000000000000010101010000010100000001010101
1010111010111010111110101010101011111110101
1010001010001000000010101000101000100000101
1111111111111111111111111111111111111111111
