1111111111111111111111111111111111111111111
1000001000000000000000001000000000000010001
1010111011101111111111101111111110101110111
1010000010100010000010000000000010101000101
1011111110111010111011111111111010101011101
1000100000001000101000100010100010101010001
1110111111101111101110101010101111101010111
1010000000000010001000101010101000001010001
1011111111111011101011101010101010111010101
1000000000100010001000001010001010100010101
1011111011101110111111111010111110101111101
1010001010001010000000001010000010101000001
1010101110111010111110101011111010101011101
1010100000100000100010101000001000100010101
1010111111101111101010101111101111111110101
1010100000100000101010100010100000000000101
1010101110111110111010111010111111101011101
1010001000100010000010100000001000101010001
1011111011101111111010111111101010101110111
1000001000100000000010001000101010001000101
1010111110111111101111101010111011111011101
1010100010001000100000100010001000100010001
1011101011101010101111111011101110101111101
1010001000101010101000001010001010101000001
1010111011101010111011101010101010101010101
1010100010001010001000101010100010001010101
1010101010111011101110101110111011111110111
1000101010100010100000101000100010000010001
1011101010101110111111101011111011101011101
1010001010100010000000001000001000001000101
1110111010111010111111111011101111111110101
1000100010000010001000001010100010100010101
1011111011111111101010111010111010101010101
1000001000000000101010000010001010001000101
1111101111111110101011111111101011101111101
1000001000000010101010001000001000101000101
1010111011111011101010101011111110101010101
1010100000100010001000100010000000100010101
1011101111101010111111111110111111111110101
1000101010001010000000001000101000001000101
1010101010111111111111101011101010111011101
1010000010000000000000000010000010000000001
1111111111111111111111111111111111111111111
