11111111111
10000010001
11101110101
10001000101
10111111101
10000010001
10111010111
10100010101
10101110101
10100000001
11111111111
