11111111111
10000000001
10111110101
10100000101
10101111101
10100010001
11111010111
10000010101
10111111101
10000000001
11111111111
