11111111111
10100010001
10111010101
10001010101
10111011101
10100000101
10101111101
10000000101
11101010101
10001010001
11111111111
