11111111111
10000000001
10111110101
10001000101
11111011101
10000010001
10111110111
10100010101
10101010101
10001010001
11111111111
