11111111111
10000000001
11111011101
10000000101
10101011111
10101000001
10101111101
10100000101
10111010101
10001010101
11111111111
