11111111111
10000010101
11111010101
10001000101
11101011101
10001000001
11101110111
10100000001
10111110111
10000000001
11111111111
