11111111111
10100010001
10101010101
10001000101
10111111101
10100000101
10111110101
10000010101
11111010101
10000010001
11111111111
