11111111111
10000000001
10111010111
10100010001
10111110111
10001000001
10101011111
10101000001
10111110101
10000010101
11111111111
