11111111111
10000000001
11101110101
10000010101
10101011101
10101010001
10101110111
10100010001
10111111101
10100000001
11111111111
