11111111111
10001000101
10101011101
10101000001
10111010111
10001010001
10101011111
10100000001
10101010101
10101010101
11111111111
