11111111111
10001000001
11101110111
10100000001
10101011101
10001000101
10111011111
10100000001
10111010101
10001010101
11111111111
