11111111111
10000000001
10111011111
10001000101
11111110101
10001000001
11101011111
10000000101
10101010101
10101010001
11111111111
