11111111111
10001000101
11101011101
10000010001
10111110101
10100010101
10111011101
10100010001
10101110101
10000000101
11111111111
