11111111111
10000000001
11101110101
10001010101
10111010111
10100010001
10101111101
10100000101
10101110101
10101000001
11111111111
