11111111111
10101000001
10101011111
10100000001
10101011101
10001010001
10101111101
10101000001
10101010101
10101010101
11111111111
