11111111111
10000010001
11101111101
10001000001
10101011101
10100010001
11101111101
10000010001
11101111111
10000000001
11111111111
