11111111111
10000000001
10101010101
10101010101
10101011101
10101010001
10111011101
10100000101
10101010111
10101010001
11111111111
