11111111111
10100000001
10101110101
10001000101
11111011101
10000010101
10111110101
10100000001
10111111111
10000000001
11111111111
