11111111111
10000000001
10111110101
10001000101
10111111101
10000000101
10101010111
10101010001
11111011101
10000000101
11111111111
