11111111111
10000000001
10101011101
10101010001
10111010111
10100010001
10101110111
10100010001
10101110101
10101000101
11111111111
