11111111111
10000000001
10101111101
10101010001
11111011101
10000000001
10101011101
10101010001
10111011101
10100010001
11111111111
