11111111111
10001010001
11101011101
10000000101
10101010101
10101010101
10111110101
10001000101
11111011101
10000000001
11111111111
