11111111111
10001000001
10111011101
10000010001
11111010111
10000010101
11101110101
10000010001
10111011101
10100010001
11111111111
