11111111111
10100000001
10101110101
10101000101
10101011101
10101000101
10101110111
10001010001
11111011101
10000000001
11111111111
