11111111111
10001000001
11101011101
10001000101
10101110101
10101000101
11101010111
10001010001
10111011101
10000000101
11111111111
