11111111111
10000000001
10111111101
10100000101
10101111101
10100010001
10111010101
10100010101
10101110101
10001000101
11111111111
