11111111111
10000000001
10111111101
10000010101
10111010101
10100010101
11101010101
10001010101
10111110101
10000000101
11111111111
