11111111111
10000000001
10111111101
10100010001
10101110111
10001000001
11111011111
10000000001
10111111101
10001000001
11111111111
