11111111111
10001000001
11101111101
10000000101
10111110101
10100000101
10101111101
10101000101
10101010101
10100010001
11111111111
