11111111111
10000010001
10111110101
10001000101
10101011101
10101000101
10101110101
10100000101
11101111101
10001000001
11111111111
