11111111111
10000000001
11111111101
10000000101
11111011101
10001000001
10111111101
10100000001
10101111111
10000000001
11111111111
