11111111111
10000000101
10111110101
10100010001
10101110101
10100000101
11111110101
10000000101
10101110101
10101000101
11111111111
