11111111111
10000010001
10101010101
10101000101
10111111111
10001000101
11101010101
10000010001
10111011111
10001000001
11111111111
