11111111111
10000010101
11101110101
10000010101
10101110101
10100010001
11101110111
10000000101
11101011101
10001000001
11111111111
