11111111111
10100010001
10101010101
10001010101
11101010101
10001010101
10111011101
10001000101
11101110101
10000010001
11111111111
