11111111111
10000010001
10101110101
10101000101
10101011101
10101010001
11101010111
10000010101
10111011101
10001000001
11111111111
