11111111111
10001000001
10101010101
10100010101
10111110111
10101000101
10101011101
10101000101
10101110101
10000010001
11111111111
