11111111111
10000000001
11111111101
10000000001
10101111101
10101000001
11111011101
10100000101
10111010101
10000010101
11111111111
