11111111111
10001000101
10111011101
10100010001
10101111101
10001000001
11101110111
10100000001
10101011111
10001000001
11111111111
