111111111111111111111111111111111
100010000000000010001000001000001
111010111111111010101010101110101
100010000010001010100010100010101
101110111010101011101110111010111
100010001010101010001000001010001
101011101110111010111011101011101
101000000000100000100010001000001
111111111111101111111110111111111
100000101000001000100010000000001
101110101011111010101011111111101
101010101000100010101010001000101
101010101110101110101010101010111
101000100010000010101010101010001
101011101011101110101010101011101
101000101000001000001010101000101
101011101111111011111110101111101
101000101000001010000000101000101
101110101011111011101111101010101
101000101000001000101000001010101
101011111011101110101011111010101
101000001000100010101000100010001
111111101110111010101110101111101
100000001010100010000010001000001
101111111010101110111011111011111
100000100000100000101000100010001
101110111111101111101110101110101
100010001000001000000010100010101
111011101111101010111010111011101
101000100000101010001000100010001
101010111110111011101111101110101
100010000010000000100000100000101
111111111111111111111111111111111
