111111111111111111111111111111111
100000000000000000000000000000001
111011111010101010101110111010101
100000001010101010100010001010101
111011111111111110111110101110101
100010000000000000001000100010101
101011101111101011101111111111101
101000101000001010000000000010001
101011101110111111111010101111101
101000100010000000001010100000101
101010111011101010101011111110101
101010001010001010101000000010101
111110111010101011111111111110111
100000100010101000001000000000001
101110101111101110111111101110111
100010100000100010100000001000001
111110111110101110101111111111101
100000000010100010101000000000001
111110101111101111111111101011101
100000100000101000000000001000101
101110111110101111101010101110101
101000000010101000001010101000101
101011111110111111101111101111101
101010000000000000101000000000101
101110111010101010101010111011111
100010001010101010101010001000001
101011111010101110111011101111101
101000001010101000001010001000001
111011111011101011101111111111111
100000001000101010000000000000001
101110111110111111101011101110101
100010001000000010001010000010101
111111111111111111111111111111111
