111111111111111111111111111111111
100000000000001010001010100000001
111111101111111010101010101111111
100000001000001010100000100010101
101110101111101010111110101010101
101000101000001000000010101010101
111011101011111111101111101110101
100000101000001000000010100000001
111011101111101111101010101111111
100000100000101010001000100010001
111011111011101010101110101010101
100000001000001000101010101010101
111110111111111111101010101110111
101000100010001000001000000000001
101010111010101111111111111110111
101010100010101000100010000010101
101110101110101011101110101010101
100000100000101000000000101000101
111110101010101110101010111010101
100000001010100000101010100010001
101111111111111111101111111111111
100010100010101000000000000000001
101110101010101011111111111111111
100010001000101000101010000010001
111010101011101010101011111010111
101010101000001010000010101000001
101011101111111111111010101010101
100010000010001000100000000010101
101110101111101110101010111110111
100010100000001000101010100010001
111010111011101011101110101111101
100000100010001000000010000010001
111111111111111111111111111111111
