111111111111111111111111111111111
100000100010100010100000000010001
111110111010101010101011111010101
100000100010001010101000100010101
111011111010111110101010111010111
101010100010100000101010100000001
101010111010101110111111111011111
100000100010000010100000000010001
111010101011101111101011111110111
100010001010001000101000000000001
111011111110101011101111111010111
100000000010101000001000001010001
101111111110111110101110101010111
100000000000000000101000100010001
111011111111111111101010101110111
101010101000000000101010100010001
101010101010101110101111111111111
100000001010101000101000100010101
111110101011111011101011101010101
101000101000100000100000001010001
101010101111101111101011101110101
100010101010000010101000100000101
111011111010111010111111101111111
100010000000001000100000000010001
101111101111111110101110101111101
100000101000100010100010100010101
101010101010101010101011111010101
101010001010001000101010000010001
101111111111111111101110111111101
101000000000000000100010101000101
101010111010111010101110101010101
100010001010001010100010000010001
111111111111111111111111111111111
