111111111111111111111111111111111
100010001010001000001000100010101
101010111011101111101110101110101
101000000010101010001000101010001
101111101110101011101011101010101
101000000010001010000000000000101
111111101111101010101111111111111
100000000000000000100000001010001
111111101111101111111010111010111
100000101010000000001010100010001
111011111010111111101110111010111
100000001010001010100010100000001
101010101010111010111111101111111
101010100000000000101010000010101
111111101010111010101011101110101
100000101010101010000010101010001
111011111011101110101110101010101
100000100000001010101000001010101
111110101010101011111110111011101
100000101010101000001010100010101
101110111011111011111010101110101
101000001010001000100010000010001
111110111010111011101110111110111
101010000000100000000010100010101
101011101011101111101110101110101
100000001010100010101000000000001
101011111010101110111010101110111
101010000000000010000010101000001
101011111011101110111111111010101
101010000000100000000000101010101
111110101011111010101010101111101
100000101000100010101010000010001
111111111111111111111111111111111
