111111111111111111111111111111111
100000100000100000001010000000001
101011101110101110101010101111101
101000001000101010100010101000101
101111111011101010111110101110101
101000100010100010001000100010101
101011101110111011101011111010101
100010001010001010101010000010001
111010111010101010101010111111101
101010001000101010100010000000101
101011111111101010111111111110111
101010000000100000001000000010001
101010111010111111101111101011101
101010100010000000100000001000101
101011101111111110111111111111101
101000100000100010100000100000101
101110111110111010101110101110101
100010000010001010101000100010101
101011111011101010101110101010101
101010001000001010100010101010101
101010111111111010111010101010101
101000100000000010000010101010101
101111101110111111111110111010101
100000001010001000000010001010001
101111111011101010111111101011101
101000000010100010100000100010101
101110111010111110101010111110101
100010100010000010001010000000101
111010111011111011111011111110101
100010001000000010100010000010101
101111101111111010101110111011101
100000001000000000100000001000001
111111111111111111111111111111111
