111111111111111111111111111111111
100000100000001000100000100010001
101110111110111110111110111010111
101000100000001000001010100010001
101110111010101110111010111011101
101000001010100010000010000010001
111110111011101110101010111011101
100000001010000000101000100000001
101011101010111011101011111011101
101010100010001000101010000010001
111110111011111111111111101110111
100010100010100000101000101010101
101110101110101011101011101010101
101010101010101000000000001010101
101010101010111111101011101011101
100000101000000010001000101000001
111010111011111010111110101110101
100010100000100000000010100000101
111011101010111110111111111011111
100000101010100010100010100000001
101010101110101110111010111011111
101010101000000010001000001000001
101110111110101110111110101111111
101000000000101010001010100000001
101110111110111011101010101110101
101000100000101000100000101000101
111111101110101110111010111111101
100010001000001000000010000000101
111011101011101110111111101111101
100000101010000010000010001000101
101111101010111011111011101010101
100000001010100010000000101010001
111111111111111111111111111111111
