111111111111111111111111111111111
101000000010101010000010001000001
101010111010101010111010101110111
100010100000000010001000101010001
111111111110111110111110111011101
101010100010001010001000001000001
101010101110101010101010101011101
100010001000100010101010101010001
101110101010111111111111101110111
100000100010000010001010001010001
111111101111101110101011101010111
101010000010000010101000001000001
101010111011111011101110111111101
100000001010001010000000001000001
101111111110111011101010111111101
100010100010100010001010001010001
101010101010101010111111111010111
101000001010001000101000100000101
111110111111111110101011101010101
100000000000101010001010001010001
101110111011101010101010101110111
100010001000000010100000101000001
101111101010111011111011111011111
100010001010100010000000001000001
111111111110111111111111111111111
101000000010001000101010000000101
101110111110101010101010111110101
101000000000100010000000001010001
101010111010101111111010111010111
101010001010101010000010000010101
101110111010101010101010111010101
100000001010101000101010001010001
111111111111111111111111111111111
