111111111111111111111111111111111
100000000000000000000000000000001
111110111011101011111011111111101
100000100000101010000000001000001
101010101010101111101011101111111
101010101010101000001010000000001
101111101111101010111111101010111
100000100010001010100000001010001
111111111011101010101110111111111
100000000000101010101000000000001
111110101111111010111011111110101
100000101000000010001000000010101
101010101010101110111011101010111
101010101010101000001000101010001
101111101110111110101011111110111
100000101000000010101000000010001
101010101011101010111011111011101
101010101000101010100000001000101
101010101111111011101011101010101
101010100000100000101000101010101
101110111011111011111111101111111
101000001000100000100000000000001
101011101011111011101111111011101
101010001000001000100010000010001
101010101010101110111010101010101
101010101010100010100010101010101
101010101110111010101111111110101
101010100010001010100000000010101
101010111010101111101110111110101
101010001010101000001000100000101
111011111111111010111011111010111
100000000000001010100010000010001
111111111111111111111111111111111
