111111111111111111111111111111111
100010101000100000100000001010001
101110101110101011111110101010101
100000001000001000101000101000101
101010101011111110101110101110111
101010101000001000000000100010101
111011101111111111111110111010101
100000101010001000100010001000001
101110101011101110111010101011111
100010101000000000100000101010001
111110101110111111111011101011101
100000101000000010000010001000001
111110101010111010111010101110111
100000101010001000100010101000001
111011101111101111101111111011111
100000101000001000100010001000001
111011101110111011101110101011101
100000101000100000100000101010101
101110101110101110101111101010101
100010100000001000100010001000101
101111111111111111111111111110111
100000100000100000001000100000001
111110111010111110111110111010101
100010100010000000100000000010101
111010101110101110101111111011111
100000100010101000101010100000101
111110101111111110101010101111101
101000100000100000001010100000101
101110101111111011111010111010101
101000100000101010001010000010101
101110101010101010101010101110101
100000101010100000101000100010001
111111111111111111111111111111111
