111111111111111111111111111111111
100000000000000000100000001000001
101111111110111011101110101011101
100010000010100010001000100010001
111011111010111110111011111111101
101000001010000000101000100000101
101111101011111111101110101110111
101000001000000000000010100010001
101011111011111111111010111011101
100010000010000000001010001010101
101110111110101111111010111010101
101000000010101000001010100010101
101111111010111011101010101110101
100000000010100000100010100010101
111111111110101111111110111010101
100000001000100010000010100010001
111110101010111010111010101110111
100010101010100010100000101010101
101010111010101110101111101010101
101000100010001000100010001010101
101111101111111011111110111010101
100000101000101010000000100010001
101110101010101011111111101011101
100010100010101000000000001000101
111010111110101011111110111110101
101010000010001010000000100010101
101010111011101011111111101010101
100010100000101000100000101010101
101110111111101110101110101010101
100010000000101000100010101010101
111011111110101011111010101011101
100000000010001000000010001000001
111111111111111111111111111111111
