111111111111111111111111111111111
100000000000000000000000000000001
111010111110111011111010111011101
100010000010100010000010100000101
101110101110101110101110101011101
100010101000101000100010101000101
111011111010111011111111111111101
100010000010001000000000000010001
111010111110101011111010101010101
100010100000101010000010101010101
101111111010111110101111111010101
101000000010000010100000100010101
111010111011111011111011111111101
100010001000001010000010000000001
111010111011101010101010101010101
100010001010001010101010101010101
101010101111101111101010101110111
101010100000100010001010101000001
101011101010101111101011111110111
101000101010100010001010000000001
111111111110101010111010111111101
100000000000101010100010100000001
101010111111101110111011101010111
101010000010001000100000101010001
101110111110111110111010111011111
100010100000000010100010100000001
111110111110101110111110111110101
100000001000101000001000001000101
101110111011101110101111111111101
100010100010001000100000000000101
101011101011111110111110101010111
101010001000100000100000101010001
111111111111111111111111111111111
