111111111111111111111111111111111
101000000000000000001000000000101
101011111011111011101111111110101
101010101010000000101010001000001
101010101111111011111010111010111
100000100000000000001000101010001
101011111011101110111010101011101
101010000010000010101010000010001
101011101110111110101111101111101
101010000010000010001000001000101
111110111110101011101110111110111
101010101000101000100000000000001
101010101010101011111111101110101
100000101010101000100000101000101
111111101111101111101110101111111
100000000000001000101000100000001
111010111010111010101111111110111
101010100010001010001000000000001
101111111111111111101011111111101
101010001010101000000010000010101
101011101010101011101010101110101
101000101000000010101000100010101
101011101010111010111111111110101
100000001010001000100010100010001
101011101110111011101110101110111
101010000000001000001010100000001
101111111111101111101010111011101
101000000000100010101000000000101
101011101011101010111010111110101
100010001000101010001010001000101
101110111111101111101110101111101
101000000010001000000000101000001
111111111111111111111111111111111
