111111111111111111111111111111111
100000000010000010101000101010001
111110101110111110101011101010111
101000100000000000000000101000001
101111111010111011101110101110111
100010000010100010100010100000001
101011111010101110101010101111101
101000101010100010101010001000101
111010101011111110101011111010111
101010001010100000101000001010101
101010101110101111111110111110101
101010101010100000000000101010001
101110111010101111111111101010101
101000100010100000100000100010101
101110101110111110111010111011101
100000000010100000101010000010101
101111101010111011101110101010101
100010001000001010000010101010001
111011111110101011101111111011101
100000100010100000001000000000101
111110101110101111101011111011101
101000101000101000000000100000001
101111101110111110111011111110111
100000101000100000001000001000101
111110101111101111111111101110101
100010000000000000000010100010101
101110111011111011101010101111101
100000101000100010101010001000001
101111101011111110111011101010101
100000100000001010000010101010101
101011111110111010111010111011101
101000001000100000100000000000101
111111111111111111111111111111111
