111111111111111111111111111111111
100010000000100000001000000000001
101110111010101111101011111110101
101000101010100010001000100010101
101011101011111010111110111010111
100010001010000010001000000010001
101110111010111111101011111111101
101000100010001000001000100000001
101010101111101011111110101111101
100010101000001000100010100000101
111111101011111110101110111110101
100000001000100010100000001000101
101111101110111010111111111011111
101000001000100010000000001000001
101111111011101111111111101011101
101000000010001000000000101000101
101011111111101011111110101111101
101010000000001000100000100000101
101010101111101110111111111110101
101010101000100010100000000000101
101011101010111010101111111111101
101000101010001010001010000000001
101110101011111011111010111110101
100010101010000010000010100010101
101010101010111110101110101010101
101010101000001000100000101010101
111010101111111011111111101011101
100010100000000000000010001000001
101010111111111111111110111111101
101010000010000000100000100010001
101111111010111110101111101010111
100000000000100000001000001000001
111111111111111111111111111111111
