111111111111111111111111111111111
100000000000100000001000100000001
101011111110111110101010101110111
101000101000100000100010100010001
101110101011101110111111111011101
101000101010001000100000000010001
111011101010111011101111111110101
100010001010101000101010000000101
101111101010101011101010111111101
101000100000100010001010100000001
101010111111111110111010111111111
101010000000000000000010000000001
101011111110111111111011111111101
101000100010100000001000100010001
101110101011101111101110111010101
100000101000100010001000000010101
101111101110111010111111111110101
100000101010000010000000100010101
111110101011111111111010101010111
100010100010001000001010001010001
101010111010111011101111111011101
101010001000100010100000000010001
101111101110111110111111111110111
100000100010000000100000000000101
101011111011111110101111111111101
101000001010000010001000000000001
101111101011111011111111111111101
100010101000001000000000000000101
111010101111101011111111111110101
100010100000100010000000000010101
101110111110111110101111111110101
100000000010000000100000000000001
111111111111111111111111111111111
