111111111111111111111111111111111
101000001010000000000010100000101
101110111011111110111010101011101
100010000000001000001010101000101
101110111111111110101110111110101
100010000010101000101000001000001
111010111110101011111110111011111
100000100000100010000000001000001
111110111110101011111111101011111
101000101000001000001000000000101
101110101011111111111011101110101
101000000000101010001010101000001
101111101111101010111010111010111
100000101000100010101010101010001
111110101011101010101110101110111
101000100010101000000010100000001
101110101110101011111110101111101
101000000010101010101010001000101
101110101110111010101011101010101
101010100010001010001010001010101
101011101111101011101011101110111
100010000000101010001000000000001
111010111011101011101110101010111
100010001010000010100000101010001
111011101010111010111011111011101
100000101010100000000000001000101
111110111011111010101110101110101
100000000010000010100010100010101
101111111011101111111011101011101
100010001000001010101010101010101
111111101010101010101110101010111
100000000010100000000000101000001
111111111111111111111111111111111
