111111111111111111111111111111111
100000000000000000000000000000001
101111111111101010101110111111101
100000000000101010100010100000001
101011111110101010111011111111101
101000001000101010001000001000001
101111101111111111101010111011101
101000000010000000001010100000101
101110101011101111111111101011111
100010101000100000001000001000001
101010101110101111111010111010101
101010101000100000100010100010101
101111101010111111111111111011111
100010001010001000000000000000001
111010101110111111101011111111101
100010101000100000001010000000001
111110111111101111101111111011101
100000000010001000001000000010001
111111101110101011101010111111101
100000000010101010001010100000001
111011111010101110111011101111111
100000001010100010100000100000001
101011101011111010101010101011101
101010001000100010101010101010001
101111111111111011101011111011101
101000000000000000101010000000101
101010101111101111101110111110111
101010101000000000100010100000001
111111101111101011101011101110111
100000000010001000101010001000001
101010111111101010111111111111101
101010100000001010000000000000101
111111111111111111111111111111111
