111111111111111111111111111111111
101000000000100000100000000010001
101011111110111010101110101010111
101000001000101010001000101000001
101110111111101110111111111111101
100000001000100010001000000000001
101011101011101110111110101011101
101000100000001010101000101010001
111111111011101010101111101111111
100000101000101000000010101010001
111011101011101010111110111010111
100010101010001010001000101000001
111010101010101011111011101011111
100000000010100010001000100000101
111110111010111010111010111110101
100000101010101000100010100010001
111110101011101111111110111010111
100010101010001000101010001010001
111010101110101011101010111010111
101000001010100000000000101000101
101110111011111011101111101110101
100010100000100000100000001000101
101010111011101111101111111110101
101000000000100010100000001010001
111011111010111010111011111010111
100000001010000010001010100000001
111011111111111011101110111111101
101000100000001010100010000000001
101110101010111010111010111110101
100010101010100010101000101000101
101010111011101010101010101010111
101000000000101000000010001010001
111111111111111111111111111111111
