111111111111111111111111111111111
100000000000000000000000000000001
101111111110111011111011111111101
101000000000001010000000000000101
101111111011111011111010111111101
100010000010000010000010000010001
111111101111111011111110111110111
100000000010000000000010001000001
101010111011101011111010101110111
101010100000101010000010100010001
101110101110111111101010111011101
100010100010000000101010100010001
101010101011101011111110101011101
101010101010001010000000101000101
101011111010101011101010111110101
101000001010101000101010001000101
111110101111101110101011111010101
100000100010000010101000100010101
111111111111101111111110111011101
100000000000000000000010001000101
101011101011101010111110101111101
101010001010001010001000101000001
101011101010111010111011111110101
101000101010001010100010000000101
101110111010101011111010111110101
101000100010101010000010000010101
101111101111111011101111101010101
101000000010000000101000001010101
101011101010101110111011101111101
101000101010100010100000101000001
101011101010111011111110101010111
101000101010100000000010101010001
111111111111111111111111111111111
