111111111111111111111111111111111
100010000000001000000000100000001
101010111111101011111111101111101
101010001000001000101000100000101
101110101011111110101010111010111
101000101000000010100010001010001
101011101110111010111011101011101
100010100010001000100010001000101
101110111011101111101110111111101
101000001000100010000010000000001
101111101111101010111011111110111
100010001000101000100010001000001
111010111010111110101110111011111
100010001010001000100010000010001
111010101011101011111011111110101
100000101000100010001000100010101
101111111110111110101110101011101
101000000010001000101000001010001
101111111011101011111011101110101
100000100000101010000010101000101
101110111110101010111010101011101
101010100010100010101010001000101
101010101010111110101011111110101
101000101010001000101010100000101
111011101010111011101010101111101
100010001000100010001000101000101
101110111111101110101111101010101
101000101000001000100000001010101
101011101011101011111110111110101
100010001010001010000010100000101
111110101010111010111010101111101
100000100010000000100010100000001
111111111111111111111111111111111
