111111111111111111111111111111111
100000100010100000000010000000001
101010101010101011111010111011101
101010101000001010100010001000101
111110101011101010111010101011101
100000001010001000100000101000101
111111111111111011111111111111111
100000001000101000001000001010101
101110101011101011111110111010101
101000100000001000001010000000001
111110111111111111101011101111101
101010000010101000100000001000001
101010101010101010101111101010101
100000101000001010001000001010101
111111111011111011111010111110111
100010000010001000001010001010101
111010111010101011101010111010101
100010001000101010001010001000001
101111111011111111111111101111101
100010000000001000000000001000001
101111101010101111111111111110111
100010001010101010001000000010001
101110101111101010111110101110101
101010101000001010101000100010101
101011101010111010101010101110111
100000001010000000000010100010001
111111111011111110111110101110111
100000101010101000001000100000001
101110101010101111111111111110111
101000000000001000000000000000001
111111111110111111111111111111101
100000000000001000000000000000001
111111111111111111111111111111111
