111111111111111111111111111111111
100000100000000010000010000000001
111010111111101010101011111111101
100010001000001000101010000000101
101111101011111111101010111110101
100010100010000010001000101000101
111010111110111010111111101011101
100010000010101010000010000010001
101011111010101011111010111110111
101000000010001000000010001000001
101111101111111110111111101011101
101000101000100010001000001000101
101110101110101011101011111111101
101000100010101010001010000010001
101011101010101011111010101110111
101010001000101010000010101000101
101010111111101010111111101010101
100010000000101000001000100010101
111111111110101111111010101111101
101000000010100000001010001000101
101010111010111111101011111010101
101010001010001000100000100010001
101010101110101010111110101111111
100010101000100010000010000000001
101111101011111111111111111111101
101000001010000000000000001000001
101011111010111111101111101011111
101010000010100000101000001000001
111010111110101110111011111111101
100000100000101000001000100000001
101110111011101011101010101111111
100010000010001000100010100000001
111111111111111111111111111111111
