111111111111111111111111111111111
100010000010100000100000000010001
111010101110101111101011111111101
100000101010001000101000000000101
111110111010111110101011101111101
101000000010000000001000100000001
101011111011111110101110111111111
101000001000000000101000000000101
101011111011111011101110101111101
101010101000100010100010100000001
101110101011111110101111111111101
101000001000100010000000100010001
101011101110111011101111101011111
100010100000001000101010101010001
101110111111111011111010101010111
100010100000000000001000001000001
111010111011101110111110101111111
101000100010001000000010101010101
101011101111101010101110111010101
100000001000101010101010000000001
111011111010111111101011101111111
100010100010100010001010100000001
101010101011101010111010101111101
101000001000101010100000001010101
101110111110101111111011101010111
100010100000000000100010100000101
101111101110101010101010111110101
101000000010101010101000100000001
101011111010111010101111111011111
101000101010001010100010000000001
101010101011101011101010101111101
101010100000101000001010100010001
111111111111111111111111111111111
