111111111111111111111111111111111
100000100010001000000010000010001
101011111010101010111111111010111
101000000000100010000010101010101
111011101110111110101110101010101
100000100010000010100010000010001
101110111011111011101111101110111
101000100010000010000000000000001
111011111111111111111011101110111
101000101010101010000010000010001
101110101010101010111111111111111
100000000000001010000010001010101
111011111111101010101111101010101
100010001010000010100000001010001
111011101010111010111011101010111
100000001010001010100010001010101
111010111011101011111110111010101
100010000010001010000000001000001
111111101010101011101010111010111
100000001010101010001010000010001
111111111111111011101111111111111
100010000000100010000000001010001
111011111010101110111111111011101
100010101010100010001010001010001
101110101010111010101010101011101
100000000010100010101000101010001
101110111110101011101111101010111
100010000010001010101000001010001
111111111111101110101010111010101
100000001000000010001010001000101
101011101010101110111110111011101
101000100010100010000000000010001
111111111111111111111111111111111
