111111111111111111111111111111111
100000000000000000000000000000001
101110111111101110111010101011101
101000000000100010001010101000101
101111101111111010101111101110111
101000000000001010101000001000001
101110101110111011101011101010101
100010101000100000101010001010101
101111111010111111111111101111101
100000001010001000000000000010001
111110101011101011101111101010111
100000101010001010000010001010001
101010101011101010111011111011101
101010101010001010100010000010001
101111101010111110111110101010101
100010001010000010000010101010101
111111101111111010101110111011101
100000001000000010101000001000101
101011111010101011111110101011101
101000001010101000100000101000101
111010111111101011101011101010111
100010000000101010001010001010001
111011111010111111111110111011101
100010000010000010000000100010001
101011111011101011101111101010101
101010000000101000100000101010101
111111111011101110101011101010101
100000000000100010101010001010101
101011101111111111111010101010111
101010000000000010000010101010001
101111111111101111101110101011101
101000000000000000101000101010001
111111111111111111111111111111111
