111111111111111111111111111111111
100000000000000000000000000000001
101011111010101011101110111010111
101000001010101000101000100010001
111011101010101010101111111011111
100010001010101010101000000000001
101011101110111111111010111110101
101010000010000000001010000010101
111010101111101010101111111011101
100010100000101010100010000010001
101011111110101110101110111110101
101000001000100010101000000010101
101010111011111110101011101010111
101010100000000010101010001010001
101111101011111111101010111110101
100000101000000000101010100000101
101011101111111011111110101011101
101010000000001010000000101000101
101110111010101111101111111010101
100010100010101000001000000010101
111010111011101111111111101011101
100010100010000010000000001000101
111110111010111111101110111011101
100000001010100000000010100000101
111110101111111010101010101110101
100000100000001010101010100010101
111010111010101110111010101111101
100010100010100010100010101000001
101110111011101111111010111010101
101000001000101000000010001010101
101110111111101011101111101010101
101000001000001000100010001010101
111111111111111111111111111111111
