111111111111111111111111111111111
101000000010000000001000100010001
101010111111111011101011111011101
100010101010101010101000100010001
101010101010101010101110111010111
101010000010100000101000000010001
101010111010101110101010111010111
101010100000000010100010100000001
111111111111111011111111111110111
100010000000001000000000100010001
101010101110101010101010111010111
101000100010100010101010100010001
111111111111111011111111101111101
100010100010000000000010100010001
101010101111101111111010111010111
101010000000001010001010100010001
111010101110101011101010111011101
100010100010101000001010100010001
101011101111101011101010101010111
101010000010001010000000001010001
111011111011101011111110111011101
100010000010001000101010100010001
111010111011101010101010111010111
100000100010001010000010100010001
111010111110111111111110111011101
100010000010000000000010100010001
111010111111111111111110101110111
100010000010000000100010100010001
111010111011101010101110101110111
100010101010001010101010101010001
101110101010111110101010101010101
100010001000001000000010100010101
111111111111111111111111111111111
