111111111111111111111111111111111
101000001000000010000000000000001
101110101011111010111110101110111
100010100010000010100010100010001
111011101111101111101011111011101
100000100000100010001000101000101
101110111110111010101110101010101
100010100010001000101000000010101
111110101011101111101111111111101
100010101000100000100010001000101
101010111011111110111010111010101
101000100010000010001000100010101
101111101110101011101011101110101
101000100000101000001000101000101
101010111111111011111110101011101
100010000000100000000010101010001
111111111110101111111110101010111
100000000000101010001000101010001
101111111111101010101011101011101
100000000010001000100010001000101
111111111010111110101111111110111
100010100010101000101000100010001
101010101110101011111010101011101
101000100010001010000010001000001
101011111010111010101111111111111
101010000010001000100000000000001
111010111011101111101111111111101
100010100010000010001000001000001
101011101011111011111011111011111
101000101010001000100010001000001
101110101010101110101110101111101
100010001000100000100000100000001
111111111111111111111111111111111
