111111111111111111111111111111111
101000000000101000001000101010001
101011101011101110111011101010111
101010001010000000100000000000101
101111111011111010101110111011101
100000100000100010000010100010101
111110111110101011101111111010101
101010000000001010101000000000001
101011101111101010101011101010101
100010001000001010101010001010101
111011101111111110111111111011111
100000001000001000001010000000001
101110111011101110111010111011101
101000001010101000000000100000101
111110101110101111111011111011101
100000101010100000000000001010001
101110111010101111101111111110101
101000100000001000001010000000101
111011101010101110101010101010101
100010001010101000101010101010101
111011101110101011101011101111101
100010001000101010000010000010001
111011111111101111111010101011111
100000001010100010000010101000001
101110111010111111101010101011101
101000100010101010001010101000101
101111111010101010111011101111101
101010001000000000001010000000101
111010111010101110101011101111111
100010100010100010101000100000001
111010101010101010111111101111101
100000001010101010100000000000101
111111111111111111111111111111111
