111111111111111111111111111111111
100000001000100010000010000000101
101011111011101111111010101010101
101000001000100010000010101010101
101010101110101110101010111111101
101010100000100000101000001000001
101010111010111011101110111110101
101010001010000010000010000000101
111111111111111111111011111111111
100000000010100000101000100010001
111111101110111010101010101010101
101000000010001010100010001000101
101011101110101010101111111111111
101000100010100010000010100010001
101110101111111011101110111010111
100000100010000000100010000010101
111110111110101110111010111110101
101000001010100010100000001010001
101010111010101111101110101010111
100010000000100000100010100010001
111111111010101110111011111110111
100000000010100010100000000000001
101111111111111111101111111111111
100010000010000000101010100010001
101110111111101010101010111011101
100010101000001010100010000000001
101110101011101110101010111110111
100010000010000010101000000010001
101110111111101111111111111011111
101000000010100000100010001000101
101010111010111010101010101010101
100010001010000010101000100010001
111111111111111111111111111111111
