111111111111111111111111111111111
100000000000100010000010000000001
101110111111101110111010111111101
100010101000100000001010000000101
111110101010111111111011111110111
100010000010000000000010100010001
101010111111111011101110101110101
101000100010001000100000100000101
101011111010101110111111101111101
101010000010101010000010001000001
101110111110101011101011111011111
101000100000101000001000001000001
101010101111101111111111101011111
101010101000100010000000001010001
101011101011111010111111111010101
100000101010000010000010100010101
111110101010101111111010101110101
100010001000101000101000100000101
111011111111111010101110111111101
100000000000100010100000000010001
101111111110101110111111111010111
100010001010001010000010000010101
101110101011111010111010111110101
101000100010000000100000100010001
101011111010111111111111101011101
101000001010100010000000101000001
101111101010101110111011101011111
101000001000101000101000101000001
101011111111101010101110101110111
101010001000001010100010100010001
101010101010111010111010111011101
101000100010000010001000000010001
111111111111111111111111111111111
