111111111111111111111111111111111
100010000000001000101000101000001
111011101110111011101011101111101
101010101010000010100000100000101
101010111010111110111110111011101
100000101000001000001010101000001
111011101011111110111010101110111
101000101000100010100010101000001
101011101011111010101110101010111
100010100010000010100010000010001
111010111011111010101110111011101
100000100000000000100000001010001
111010111110111111101111101111111
100010001010100000001010000000101
111111101010111110101011111010101
101000000000100010101000001010101
101111101110101110111011111111101
100000100010000000000000100010001
111110111110101111101011111010111
100000000000100010101010000000001
111111111110101110111010111110111
101000100000100000100000001010001
101110101110111110101010101010101
100000000010001000101010100010101
101111101110111111111011101110101
101000001000000000100000100010101
101111101111101110111011111110101
101000000010000010001000100010101
111111101010101011111010111011111
100000001010101010000010001000101
111111101111111111101011101110101
100000000000001000001000100000001
111111111111111111111111111111111
