111111111111111111111111111111111
100000000000000000000000000000001
101011101010101111101010111010111
101010001010100010001010001010001
101011111110101010111110111011101
101010000000101010001000001010001
101110111011101110111011101111101
101000100010000010001000101000001
111111101110101010101011111011101
100000000010101010101010000010001
101111111110101110101011111111101
100010000000100010101000000000101
111011101011101011101011111110101
100000101010001010001000001000101
101110101110101111111110111011101
100010100010100000000010100000101
101010101011111110101111101111101
101010101010000000101000000000101
101111111010101011111110101110101
100010000010101010000000100010101
111011111011101110111011111010101
100000001000101000001000100010101
101110111011101111101110101010101
100010100000101000000010101010101
101111111011111010111011101011111
101000000000100010100000101000001
101111101110111010101010101010111
101000000010100010101010101010001
101110101110111111111111111010111
100010100010000000000000100010001
101111101010101111111111101011111
101000001010100000000000101000001
111111111111111111111111111111111
