111111111111111111111111111111111
100000100010001000001000001000001
101110101111101011101110101110101
100010000010000010000000101000101
101111111011111111111110111110111
100000100010001010100010101000101
111110101111101010111010101110101
100000100010000000100000101000001
101111111010111011101111101110111
100000100010001000000000000010001
111111101111111110111111111010111
100000001000000010001010101010001
111010111011101110111010101010111
100010000010000010000000001000001
101110111110111010111011111011111
100010000010001010001000001000101
111111111011101110101011111010101
100010001010001000101000001010001
101111101010101011111111101111101
101010000010100010000000001000001
101011101111111010101010111010111
100000000010000010101010001010001
111111111011111111111111111111111
100010001010101010000000100000001
111011101010101011101111111111101
100010001000000010100010101000001
101111101111101010101010101011101
100010000000001010001010100010001
101010111011111011111010101111101
101010001000101000001010100010101
101111101011101011101010111010101
100000001000001010000000000010001
111111111111111111111111111111111
