111111111111111111111111111111111
101010001000101000101010000000101
101011101110101011101011111011101
100000001000100010001000001000101
101111101110101111101011101011101
101000000000101000100010101010101
101111101010101011101110111010101
101000101010000010000000000010101
111110111110111110101110101110101
100000100000001010100010101010001
111110101110101010111111111010111
100000001000100010000010001000101
111111111110111110111011101011101
101010100000101000001010000000001
101010111110101110101111101011111
100010100010001000101010001000001
101110101111101110111010101010101
101000000010000000100010101010101
101111101111101111101110111011101
101000100010001000000000001010101
101110101111101011101111111110101
100000000000000000101000101010001
101011111011111011111110101010111
101010101010100000100010000010101
111010101110101110101110111111101
100010000000000010000000000000001
111110111011101110101110111110101
101000101000101000100010101000101
101111101010101110101010101111111
100000100010100010101010000000001
111011111010101110111010111011101
100000000010101000100010001000101
111111111111111111111111111111111
