111111111111111111111111111111111
100010100000001000000000000000001
101010101111101010111111101111101
101010100010100010100000001000101
101010111010111110111111111010101
101000101010001000100000000010101
101110101011101011101111101110101
100010001000101000001000101000101
101011101110101111111010111011101
101010001000100010001010000010101
101011101011101010111011111110101
101000101010001010100010100010001
111110101011101010101110101010111
100000101000101000100010001010101
101111101110101111111011101010101
100000100010001000001000101010101
111110111111101011101110101010101
100010000000001000101000101010001
101011111111111111101011111011101
101000100010000000101000001000101
101110101010111010101011101010101
101010001000101010101000101010001
101011111111101010101110101011111
100010000010001010101000101000101
111010111010101011101111101110101
100010101000101000001000100010001
101110101111101111111010111011111
100000100000100000000010001000001
111111101011111111111111101011101
100010001000000010000010001010001
101010111111111010111010111110101
101000000000001000001000000000101
111111111111111111111111111111111
