111111111111111111111111111111111
100000000000000000000000000000001
101011111111101110111010101110101
101000000000101000001010100010101
101010111110101010101010111111101
101010100000101010101010000010001
111011111111101110101110111110101
100000100000000010101000000010101
101110101111101011111011101110111
101000100000101010000000101000001
111010111010111110101110101010101
100010001010100000101000101010101
101011101111111110101010101010101
101010000000000010101010101010101
111010111011101110101011111011101
100010100000101000101000001000101
111111101110111110111011101110111
100000001000001000001010001000001
101110111111101011101010101111101
100010000000101000101010101000001
101011101110111111111011111110101
101010000010100000000010000000101
101011111110111111101110111010101
101000001000001000001000001010101
101011111011111111101010101011101
101000001010000000001010101000101
111011111111111011111010111111101
100010000000000010000010001000001
101111111010101011101010101110111
101000000010101010001010101000001
101011101111101011101110101111101
101000101000001010001000100000101
111111111111111111111111111111111
