111111111111111111111111111111111
100000000000000000000000000000001
101011111111101110111111111011111
101010000000001000001000000000001
101110111110101111101010111010101
101000001000100010001010100010101
101010101010101011101110111110101
101010101010101010000010000010101
111010101011111111111110111010101
100010101000000010000000100010101
101111111010101111111010111010101
100000001010100010000010001010101
101110101011101010111110101011111
100010101000101010100000101000001
111011111010111010111110101010101
100010000010001010001000101010101
111010101011101111111111111010101
100010101010000010000000000010101
101110101011101011111011111110101
100010101010001010000000001000101
111010111010101010101111101011111
100010001010101010100000101000001
101111111011101111101011111010111
100000001000101000001000001010001
101011111110101011111110111011101
101000000010101010000000001010001
111011111011101011101011111110101
100000001000101000101010000000101
101110101011101110111011101011101
100010101000101000001010001000101
101010111011101111111011111011111
101010001010000010000000100000001
111111111111111111111111111111111
