111111111111111111111111111111111
100000101010000010001000100000001
111011101010111110101110101111101
100000100000000000101000000010001
111110111010111111101111101111111
100000000010100010001000100000101
101110111010101011101110101111101
101000100010001010001000100000101
111111111111111011111110111011101
100000001010100000000000100000101
101010111010111011111011111010101
101010101010100000001000100010101
101010101010111110111110111011101
101010000000000010001000000000101
101111111110111011101111111011101
100010000010100000001000000000001
111010101110111010111110111111111
100010100010101010001000000000001
111010101110101010101111111011111
100000100010100010101000000000001
111110111111111011111110111111111
100000000000100000001000101000101
111110111111111111111011101110101
100000001000001010001000001000101
101110111110111010101011101011101
100010001000001000101000100000101
111011101010101011111011111011101
101010001010101010101000100000001
101010111011111010101111111011111
100010000000000000001000100000001
111110111111111111111010101110101
100000000000000000001010000010101
111111111111111111111111111111111
