111111111111111111111111111111111
100000000000000000000000000000001
101011111111101111101010111110111
101000000010001000001010001000001
111110111011101010111111111110101
100000100000101010000000000010101
101011111010101010111111111110111
101000001010101010000000001000001
101110101110101110111011101011111
101000101000101000001000101000001
101111101010101010111110111010111
101000001010101010001000100010001
101010111110111111101011111110101
101010100000000000101000100000101
101110111111101010111111101111101
101000100000001010100000000000101
101111111011111111111111101010111
101000000000000000000010001010001
101110101011111110101111101010111
100010101000001000101000001010001
111111111010101011111110111110101
100000000010101000001000000010101
101111101111111111101111111110101
100010000000000000100000000010101
101110111111101010101011101110101
100010001000001010101010001000101
101011101110111110111011101110101
101010001000000010001000101000101
101110111010111110111111101110101
101000001010100000000010001000101
101110101010101110111011101011101
100010101010100010100000101000101
111111111111111111111111111111111
