111111111111111111111111111111111
100010000010100000001000000000001
101111101110101110101011101111101
101000100010000010100010100000101
101011101111101011111110111010111
101010100010001000101010001010101
101010111010111111101010111111101
101000001010101000100010000000101
101011101010101011101110111011101
100000101000000000100000101000001
101111111011101111101011101110101
100010001010001000101010000010101
101110111011101110101110111111111
101000001010100010000000000000001
101011101110101110111010101010101
101010101000000000101010101010101
101010111011111011101111111111111
100000000010000000001010001000101
101011111011111010101010111110101
101000001010101010100000101010001
101011101110101111101010101010111
101000100000000010001010000000101
111010111111101111111111101010101
101010000000101000000010001010001
101110111011111011101011101010101
100000101000000000101010001010101
101110101010111011111010101110111
100010100010101000001010100010001
101110111011101111111111111110111
101010100000000000000010101010101
101010111010101011101110101011101
100010001010101000100000000000001
111111111111111111111111111111111
