111111111111111111111111111111111
101010000010000000000000101000101
101011111011101111111011101011101
100000101010000000001010001000001
111011101010111111101111101110111
100000101000001000101000000010001
101011101110111011111111111010111
101010000010001010000010001010001
111011111010111010101110111010111
101010101010101010101010101010001
101010101010101010111010101010111
100000101000000010001010100000001
111011101011101110111010101111101
100000101010001000001010000000101
101011101011111111101010111011111
101010000010001010000000001010001
111011101110111011101110111110111
100000001000100010001010100000101
111011111110101110101011101110101
101010101000100010100000000010001
101010101011101010111011101011111
100000100000001000001010001000101
111110101110111011101111101010101
101010101000001010100000101010001
101010111011111010101010101110101
100000101000100000101010100010101
111010101011111011111110111011101
101010000000001010001000101010001
101110111110111110111111101110111
100000001010000000000010000000101
111010101010101110111110101110101
100010100010100010000010101000001
111111111111111111111111111111111
