111111111111111111111111111111111
100000100000000010000000001000001
111110101111111011111110111010101
100000001000100010001000101010101
101011101010101110101110101011111
101000100010100010100000001000001
111111111111101110111010101011111
100000000000000010001010101000001
111110111111111110111111101110111
101000001000100010101000101010001
101011101011111010101010101010101
101010000010100010000010101000101
101110111010101110111111111111101
101000001000100010001010000010101
101111101111111010101010111010101
101000100010100010100010101000001
101010101110101110111010101110111
101010100010100010001000001000001
101010111010111011101011111011111
101010000000100000101000001000101
101011101110101110101011111010101
100010000010000010001000001010001
101111111110111110111111111110111
101000000000000010000000001000001
101111111111111111111111111111111
100000101000001010101000000010101
111011101111101010101010101010101
101010100000101000001010101000101
101010101110101111101011111110101
101000001000000000000000101010001
101011101110111011111010101010101
100000101000001000001010000010101
111111111111111111111111111111111
