111111111111111111111111111111111
101000001000000010100000001000001
101011111011111010101011111011101
101000100010000010101000100010001
101110101010111110101110101110111
101000101010000010001000101000101
101011101111111011111011101011101
100000100000100010001000001000001
101110111010101110101110111011101
101000100010100000100010001000101
101011111110101111111110111010111
101010000010101000000010100010001
101010101010101011111011101111101
101010101000101000001000001000101
101010101111101111101111111011101
101010100000101000101000100000001
101010101111101010101110101111101
101010101000101010001000101000101
101011101010101011111011101011101
101010001010001010000000101000001
101010111011111010101111101110111
101000001010001010100000101000101
111111101010101011111110101010101
100000101010100010000000101010101
101111101010111010111111101110101
101000001000001010100000100010101
101011101111101010101011111010101
101010001000001010101000000010001
101010111011111010111111111111111
101010101010001010000000001000001
101010101011101111111111101011101
100010001000000000000000000010001
111111111111111111111111111111111
