111111111111111111111111111111111
100010001010001000000010100000001
111010111011101110111110101111111
100000100000000000001000101010001
111110111111111111101011101010111
100000101000100010000010000000001
101110101110101111111011101111111
101000001010001000001000001000001
111111101011101011101110111010111
101000100000000010101010000010001
101011111110101010111011101111111
101010100000101000001000001000001
101010101111111011111111101110101
100010101010100000100010000010101
111010111010101011101011101110111
100000101000101000101010000000001
111110101110111011111010101111111
100000100000001010001000101000101
101110101110111011101010111011101
100010001000001010101010001000001
111110101110111010101110111011111
100000101000001010000000000000001
111011111010101010111010111011101
100010001010101000001010101010101
101111101111101110111111101110111
101000101000000000000010000010101
111110101110111010111111101110101
100010000010001010000010000000001
111011101011111110111110101110101
101010001000000000000000101010101
101010101111101010101010111011111
100000101000001010101010000000001
111111111111111111111111111111111
