111111111111111111111111111111111
101000000000000010101010001000101
101011101110101010101010101110101
100000100010101010001000100000101
101110101111101111101011111011101
101000100010000000001000001000101
101111111111111011101111101110101
100000100010100010100000001000101
111011101010101010101111101110101
100000101000001010001000001000101
101111111111111111111111111111101
100000001010000010000000100010101
101010101010101110101011101110101
101010101010100010101000000010001
101110111010111010101011101110101
100010001010100000101000100010101
101110111011111011111111101110101
100010001000001000001000001010101
111010111011101011101011101010101
100010001010100010001000100010101
101111101010101010101011101010101
100010101010001010101000101000101
111010101011111011111110111110101
100010001010001000101010000010101
111010111010111110101010101010101
100010000010000000001000101010101
111010111111111111111011111110101
100010001000100000101010000010101
101010111110111110101010101110101
101010001010001000000000100010101
101111101010101010101110111010101
100010001000100010101000100010101
111111111111111111111111111111111
