111111111111111111111111111111111
101010000010101010001000001000001
101011101110101010111011111011111
100010101000000010000000100010001
111010101110111110111110111011101
100010000000100000101010100000101
111010111111111011101011111011101
100000101000000000001000101010001
111110101111111011111011101010111
101010000010101010000000000000001
101011101110101011101111101010111
100000000010100000000000101010001
101110101110101110111010111010111
100010101010000010001010001010101
111110101011101111101110111010101
100000100000000010100010101010001
111011101010111010111111101110111
100010001010100000000000000010001
101010101111111011101011101110111
101010100010101000101000100010001
101011111010101111101011101110111
101000100000000010001010101000001
111010101011111011111010101110111
100010101000101010000010000010001
111011101110101111101011111010101
100010101000001000101000101010101
111010111110111011111010101111101
100000100000000000101010000000101
111010111110111110101011111110101
101010101000101000100000000010101
101011101110101110111011101111101
100000000010000010100010000000101
111111111111111111111111111111111
