111111111111111111111111111111111
100000001000000000100010001010101
111110111011111111101010101010101
100010000000000000001000100000101
101011101111111010111110111110101
101010101000100010001010000010001
111010111010111111101011101110111
100000001010000000000000101000101
111110111110111110111011111011101
100010000010100000100010100010001
101110111011101011111110111111101
101000001000001000100000101010001
101110101111111111101111101010111
101000100010000000001000100000001
101110101111101110101110101110101
100010100000100010101000101000101
111010111010101110111010111110111
100000001010101000100010100000001
111110101111111011101111111110111
101000100000100000100010001000001
101011111011111011111011101111101
100010001010000000000000001000001
101110111010101111111011111011111
101000100000101000000010001010001
101110101111101011111010101010101
101000000000101000100000100010101
111111101110111011101110101010101
101000100010101000100010101010101
101010111011101011111110101111101
100010001000100010001000100000001
111110101011101110111111101011101
100000100000101000000000001000101
111111111111111111111111111111111
