1111111111111111111111111111111111111
1000000010001000001000100010000010001
1110111010111011101110101110101010101
1000101010101010100010001010101000101
1011101010101110101110111011101110111
1010000000000000100010001010001000001
1011111111101010111011101010101110101
1000100010001010100010001010101000101
1011101111111110101111101011111011101
1010001000001000000010101010100010001
1110111110101011111010101010111011101
1000000010100000001010001000000010001
1011111010111011111011101011111011101
1010000000101010101000001000101010101
1111101110101110101110101010101110111
1010001000001000001000101010000010001
1010111011111110111111101110111110111
1000100010100000000010100010000000001
1111101110101110101110101111101111101
1000000000000010100010100000000010001
1111101111111011111110101110111111101
1000101010000010001000000010001010101
1010101011101111101111111011111010101
1010100010000010100010000010000010001
1110101111101110111011111110111110101
1010001000100010100000101000001010101
1011101011111110101111101010111011101
1010001000100000000010000010100010001
1010111110101110111111101011101111101
1010000010101000000000101010000010001
1011111010101111101111111010111011101
1000000000000010000000000000100010001
1111101011111010101110111010101110111
1010001010000010100010001010101000001
1010111110101010111010111110111010111
1000100000101010100010000010100010001
1111111111111111111111111111111111111
