1111111111111111111111111111111111111
1000001000101000000010000010001000001
1110111010101011111011111011101011101
1000100010101000001000001000101010001
1010101110101111101111101110101010111
1010101000001000101000100010100010001
1010101111101010101010111010101111101
1010100010001010001010100000101000101
1010111010111011111011101111101110101
1010001010001000001000001000001000101
1010101010101111111011111011111011101
1010100010101000001010000000000010001
1110111110101011101010111111111010111
1000100010101000100010100000000010101
1011111010101111101111101111111110101
1000001000100000001010001000001000101
1011101111111111111010111110111011101
1000101000100000100000100000001000101
1110101110101110111110101111101010101
1000100010100010000000100000100010101
1011111010111011111110111111111110101
1000001010001000000010000000100010101
1111101011101111111011111110111010101
1000001000100010001010100010001000001
1011111011111010101010101011101011111
1010100010000000100010001010001000001
1010101110111110111111101110111111101
1010100000001010001000000000100010001
1010111011101011101011111111101010111
1000001000101000101000100010001010001
1111111110101011111110101011111011111
1000000010101000000010001000001000001
1011111010111011111011111110111011101
1010000010001010001000000010000010001
1011111110101011101011111011111110111
1000000000101000001000001000000000001
1111111111111111111111111111111111111
