1111111111111111111111111111111111111
1000000010001010101000000010001010001
1111101110111010101110111111101011101
1000000000001010001010000010001010101
1111101111111010111010111110111010101
1000101000001000001010001000000000101
1110101011111111101010111110101011101
1000100000100010100000000010101010001
1010101011101010101010111110111011101
1010101010101000101010101010001010101
1011111010111011101111101010111110101
1000100010101010001000100000101000001
1011111010101011101011111011101011111
1000100000100000000010001010101010001
1011111110111011111111101010101010111
1010100010001000101010101000101000101
1010111010111011101010101011101011101
1000101000000010001000000000001000001
1010101111111011101010111111111010111
1010001000001010000010100000100010101
1110111010101011111011101111111010101
1000001010101010100010101000000010001
1110111110111010111010101011111011111
1000001010100000000000000000100010001
1110111010101110111010111011111111101
1000001010001000001010101000000010001
1110111010111010111011101110111110101
1010001010101010100010100010001010101
1010111011101011111110101111111010111
1010100000101000000010000010101010001
1010111011101011111110111110101010111
1010101000100010001000101010101000001
1010101011101111101110101010101110111
1000000000000000000000000000000010001
1010111110101011101011111011101110111
1010100000101000101000001010000000001
1111111111111111111111111111111111111
