1111111111111111111111111111111111111
1000100000000000100010000010101000101
1011111011101111101110111010101011101
1010001010000010100010100000001010001
1011101110101110101111111111101010111
1000101000101010100000100010001000101
1011101011111010101111101111101110101
1010001010001010001000001000000010101
1011101010111011101111101111101110101
1000001010000000001000000000101010001
1111101011111111101111101111101011101
1000000000101000101000100010100000101
1111101011101011101011111010101111101
1010001000101000001000001010000010001
1011111011101110111010111011111011101
1010100000001000001010001000100000001
1010111011111010101110111011111010111
1000100000001010101000101000001010001
1110111010111110111110101011111110101
1010000010100010001000001010001000101
1011101111101111101110111010111111101
1000000010100000100010000000001000001
1010101110101111101110111011111110111
1010101000001000100010101010100000101
1011101111101110101111101010111110101
1000100000000000001010000000001000001
1111101010101111101010111010111010111
1010001010100010100000001010101010001
1011101111111010101110111111101011111
1000101000101010001000100010100000001
1110101110101111111110111010101110101
1000001000000000000000001000000010101
1110111010101110111110101110111011111
1010100010101010100010100000001000001
1011111011101011111010111011111011111
1000000000101000000000100000001000001
1111111111111111111111111111111111111
