1111111111111111111111111111111111111
1000001010000000001000101000001010001
1010101010111010111110101110101010111
1010100000001010001000000000100000001
1110111111111110101110111011101111111
1010101000100010101000001010000010001
1010101110101011101110101011101011101
1000000000001010100000101000101000101
1110101011111110111011111011111111101
1010101010001010100000100000000000001
1011111011101010111010101110111011101
1000101000100010000010100010100010101
1110101011101110111011111111111110111
1010001000100010001000101000001000001
1011101110111010101111101110111011101
1000101010100010101000100000001010101
1011101010111010111011101011111010111
1000100000001010000010001000001000101
1110101110111011101111101011111011101
1000001010001000000000001000000000001
1011101011111111101110101111111010111
1000100000000010000010101010001010001
1011101110101111111011111010111110101
1000100010100010001000000000001010101
1010101110101111101110101011111010101
1010101010100010000010101010101000101
1011101011111110101111111010101010111
1000100000000000101000001000001010101
1010101111101111111110101110111111101
1010100010000000101000101000101000001
1111111010111110101011111011101010111
1000000010001000001000000000000010001
1010101111101111101110111010111011111
1010100000100010101000100010001000001
1011101010111110111011111011101111101
1010001010000000001000001000101000001
1111111111111111111111111111111111111
