1111111111111111111111111111111111111
1000000000000000000000000000000000001
1010111011101111101110111011101010101
1010100000100000100010100000101010101
1111101111101110101110101110101110111
1000000000100010101000101000101000001
1111111011111111101010111011111010111
1000000000000010001010001000001010001
1010111011101110101111101010111110101
1010001000100010101000001010000010101
1010101110111011111111111110101111101
1010101000100000000010000000100000101
1010111010111011101110101110101110111
1010001010001000100010101000100010001
1011101110101110111111101011101010101
1010001000101000100000001000101010101
1010101010101010101111111111101111101
1010101010101010100000000010000000101
1011101111101111111110111111111011111
1000100000101000000000100000000000001
1011101011111011111110101111111010111
1000101010000000000010101000000010001
1010101011101011111110101111101110101
1010101000101000001000101000001000101
1111101010111011111110111011111010101
1000001010001000100000001000100010101
1011111011111111101110101011111011111
1000001000000000100010101010000000001
1010111111101111101110111010101111101
1010100000000010001000001010100000101
1010111011101111111111101011101010101
1010001010000000001000001000101010101
1010111010101111111110111111111010101
1010100010100010000000000010000010101
1110111110111010111111111111101110101
1000000010001010000000100000000010101
1111111111111111111111111111111111111
