1111111111111111111111111111111111111
1000000000000000000000000000000000001
1110111111111111111111101110111110101
1000100000000000000000001000000010101
1011111111111010101110111011101011101
1000000000001010100010001000101000101
1010101010111010101011101111111011101
1010101010001010101010000010000010001
1010101011111010101111101110111011101
1010101000100010101000001000100000101
1011111010101110111010111010111111101
1000100010100010100010100010100000001
1110111010111011101010111011111011101
1000001010100010001010100000100010001
1110101010101111101111111110101010101
1000101010100010001000000000101010101
1110101111111010111011101010111111101
1000101000000010100010001010100000001
1010111010101110101111111011111110101
1010001010100010100000001010000000101
1110111111101010101010101111111011111
1000000000101010101010100000001000001
1011111111101011111110101110101011101
1010000000001000100000100010101010001
1110111111111111101010111011101010101
1000000010000000001010001010001010101
1010111010111011101011111011101111101
1010001010001000101010000010000010001
1110111110101110111111111011101010101
1000000010100010001000000010001010101
1110101111111110101011101110101110101
1000100000100000101000101000101000101
1010101110101110101111101011101010101
1010100010100010100010001000101010101
1111111110111111111011111110101011101
1000000000000000001010000000101000101
1111111111111111111111111111111111111
