1111111111111111111111111111111111111
1010100010001000001010000000000000101
1010101111101110111010101111101111101
1000100000100000000010101010100000001
1110111011111011101110111010111011101
1000100010000000101000000000001010001
1110111010101111101110111110101111101
1000101000101000000000000010100000101
1010101011111111101110111011111111101
1010101010001000000010100010000000101
1110101111101110101111101011101111101
1000100000000000100000101000000010101
1010101110111011101111111011111110101
1010101000100010100000100000000000101
1011111110111010101110111011101111111
1000000000101010000010100000101010001
1110101110101010101111111011101010111
1000101000001010101000001010000000101
1111111011101111101010111010111011101
1000000010101010000010001010001000001
1010111110111011101111111010111011101
1010101010000000000000001010001000101
1011101011101010111111111110111011101
1010001000001010001000001000101000101
1011101110101011101010101010101011111
1010100000101010000010101010001010001
1110101011111110101010101110111010111
1000001000001000101010101000001000001
1011101111111110111011111010101010111
1010000010001000101000001010101010001
1010101011101110101010111010101011101
1010101010000000001010001010101000101
1010111011101110111010111110101011101
1010001010100010001010000010101010101
1111111010111111111111111010111010111
1000000000000000001000000010001000001
1111111111111111111111111111111111111
