1111111111111111111111111111111111111
1000000000000000000000000000000000001
1010111011101110111011111010111111101
1010100000100010001010000010001000001
1010101111111111101110101111101111101
1010100000000010000010101000000000101
1011101010111111111111101110101010101
1000101010000000001000000010101010101
1011101010111110101111111010101011101
1000101010001000101000000010101010001
1010101011101010101110111111101010111
1010101000101010100010000010001010001
1110111011101111111110111111101011101
1000100000101000000000001000001000101
1110101110111010101110111011111010101
1000100010001010101000100010000010101
1011101111111111101111101011111110101
1010000000000000100000101000100000101
1110111010101010101011111010101010101
1000100010101010101010000010101010101
1010101110111110101010111011101010111
1010100010100000101010001010001010001
1010101111101010111011101111101110101
1010100000101010001010000000100010101
1011101010111110111111101111101011101
1010001010001000000010001000001010001
1011111011111010101010101110101111101
1010000010000010101010100010101000001
1110101010111111101010101111101011111
1000101010000000101010100010001000001
1011101110111011101111101110101011111
1010000010100010000000100010101000001
1010111111101111111010101010111110111
1010100000000010000010101010000010001
1010111110101111111010111111101111101
1010100000100000001010000000101000001
1111111111111111111111111111111111111
