1111111111111111111111111111111111111
1000000000000000000000000000000000001
1111101110111011101010101011111110111
1000001000001000101010101000100000001
1010111111101111101111111011101010101
1010000000100000100000100000101010101
1111101010101011101010111110111111101
1000001010101010001010001000001000001
1110111011101110101111101110101010101
1000100000100010100000100010101010101
1010101010101011111110111111101010111
1010101010101000000010000010001010001
1010111111111111101011101110101110101
1010000000000000101010000010100010101
1011101111101111111110111111101110101
1000100010001000000000001000001000101
1011101010111110101010111011101010111
1010001010100000101010100000101010001
1011111111101110101111111111111010101
1010000000000010100000000010000010101
1011101011111011111010101111101010111
1000101010000000001010100010001010001
1010101010101111101110111110101010101
1010101010100010001000001000101010101
1110101011111011101110111111111111101
1000101010000000100010100000000000001
1010101111101011101111101110101010101
1010100000101000100000101000101010101
1111101111111110111110101111111110111
1000000000001000001000100000000010001
1010101010101111101110111110111010101
1010101010101000000010001000001010101
1011111110111110111010111110101011101
1010000000100000100010000010101010001
1010111011101111101110101111111110111
1010001010001000000010100000100000001
1111111111111111111111111111111111111
