1111111111111111111111111111111111111
1000000010000010001010001000001000001
1011101111111011101010111110111010101
1000100010001010000010000000101010101
1110111010101010111111101010101110101
1010100010100010000010001010000000101
1010111010111111101011111110111111101
1000100010000010001010100000001000101
1111101111101110111110111011101011101
1000000000000000000010100010001000101
1111111011111111111110111011101110101
1000001000100010000010001010000000101
1011111011101010111010101010101011101
1010001000101010100010100010101000101
1010111110101110111111111110111111111
1000000000000010000010101010000010001
1011111111111111101110101010111111101
1000100000100010000000100010100000001
1011111011101110111110101010101110101
1000100000100010000010001000000010101
1011101111111011101110101111111010111
1010101010100010001010101000000010001
1010101010101110111010101111111010101
1000000000100010000010101000000010101
1011101111101011101010101110111111111
1000100000001000001010101000000000001
1111111111111110111111111111111111111
1000100010000000101000000000000000001
1110101110111111101110111011101011101
1000100010100000101000100010001010101
1110111010111010101110111010111010101
1000100000100010000010100010001000101
1110101010101010101010101110111110101
1000001010001010101000100010001000101
1111101111111111101110101111111111101
1000000010000000001000100010000000001
1111111111111111111111111111111111111
