1111111111111111111111111111111111111
1000100000001000000000100000001000001
1010101111101011111110101110101011111
1010101010000010000010100010100010001
1010101010111110111010111010111110101
1010001010001010101010101010100000101
1011111011101010101010101010101011101
1010001000100010101010000010001010001
1010101110111110101110111111111010111
1000100000100000100000100010000010001
1111101111101110101110111010111111101
1000101000101000100010100010100000001
1010101010101011111010101111101111111
1010101010101000000010100010001000101
1010101010111111111111111010111010101
1010101010001000100010001010000010101
1010101011101010101010101011111010101
1010101000100010101000100010001010001
1010111110111110111010111110101111101
1010100010100010000010001000100000101
1010101010101011111111111011111110101
1010101000001000100000100010000000101
1110101110111110101110101110111111101
1000101000101000100010001000100010001
1011101111101011111011111110111010111
1000100010100010000010000000000000101
1110111010101110111111101111111111101
1000101010100010001000100010001000001
1011101010111011101010111011101011101
1000000010001010101010000010001000101
1011111011101010101011111110111111101
1010001000100010001010000000000010001
1010111110111110111010111111111010111
1010001000000010001000100000001010101
1010101011111111101111101111101010101
1000101000000000000000001000001000001
1111111111111111111111111111111111111
