1111111111111111111111111111111111111
1010000010000010001000101000001010001
1010101011101110101010101110111010111
1010101000100000101010000000100000101
1010101110101010111011101010101010101
1000100010001010001000101010001010001
1111111111111111101111111111111011111
1000000000000000001000001000001000001
1111111111111011111111101111101011111
1000100010101000101010100000000010001
1011101010101110101010101110101010101
1000101010000000101000001000101000101
1011111010111111101111111111101111111
1000000000100000101000000000000000001
1011101110101011101111111111101111111
1010100010101000101000000000000000001
1010101010101010101111111111111110111
1000101010001010101000100000001000001
1011111110111111101110101111101011101
1000101010100010101000101000101000101
1110101010111010101011101011101111101
1000100000000000101000000000101010101
1110111111111111101011111011111010101
1010000000001000001000100000001000001
1010111010101011101110101010111011111
1000001010100000101000101010000000001
1111111111111011111111111111111111101
1000100000001000001010001010000000001
1110101111111110111011101010111111111
1000100000001000001010000010001000001
1011111111101110101010111010101111101
1000100010001000101000001010100000101
1011101011101011101111111011101010101
1000101010001000101000100010001010001
1110111010111011111010101010111111101
1000000000000000000010001000001000001
1111111111111111111111111111111111111
