1111111111111111111111111111111111111
1010001010001010100000000000100010001
1010101010101010101110101110101010101
1000100000101000001000100010101000101
1111111011111110111110111110111110111
1000000010001000001000100000101000001
1010111111101011101010101111101011111
1010100000001000101010100000101000001
1010101010111110111111111110101010101
1010101010001010001010101010100010101
1010101110111010111010101010111011111
1010000010001010001010100000000000001
1111111011101010111010101110111010101
1000000010001000000000100010100010101
1111101111111111111110111111111011101
1000001000000000000010000000100000101
1111101011111110111110111011111011111
1000001000001000100010100000100000001
1111101010111010111010111110101111111
1000101010001010100010101000100000101
1110101011111011101110101010101110101
1000000000001000000000100010100010001
1011101011101111111111111111111111101
1000101000101000101000001010000000001
1111111011111110101011101011101110101
1010000000101000000000100010100010101
1010101110101111101111111010111011101
1000101000001000000010001010100010101
1011111110111010111011101010101110101
1010001000001010100010001000000010001
1010111111101011111010101110111111111
1010001010001000100010101000000000101
1010111010111111111010111110101011101
1010000000001010000000101000101000001
1010111111101010111010101110101011101
1010001000001000100010001000101000101
1111111111111111111111111111111111111
