1111111111111111111111111111111111111
1000000000000010101000101010000000001
1110101110101110101010101011101111101
1000101000101000101010000010000000101
1111111110111010101010101010111111111
1010101000000010000010101000101000101
1010101010111011101111111110101011101
1000101010001000100010000000000000101
1011101010111110111111111111111110101
1000001010001010000000000010100000001
1010101011111011111010101110101111101
1010101000001010000010100000101010101
1011101111101010101011111110111010101
1000100000101010101010100000100010001
1011111010111010111010101011111011101
1010001010001000100010001010000010001
1110111111101110101110111010111111101
1000000000101000101010101000101000001
1010111111101010111010101011101110101
1010000000100010100010101010001000101
1110111110101111111010101110101011111
1010100000000000100010001000101000001
1011111011101111111010101110111111111
1000101010101000000000101000000000001
1110101010111010111110111011111111101
1000000010101010101000000000001000001
1010111010101111101111111010111010111
1010001010000000100010000010001010001
1011111011111011101010101111101011111
1000001000000000001010101010001000001
1111101110111011101111101011111111101
1010001000100010100010001000100010001
1010111110101110101010101011101111101
1000100000100010101010100010000010001
1010101111101010101011101010111110101
1010100010001000101010001000000010101
1111111111111111111111111111111111111
