1111111111111111111111111111111111111
1000100010101000100000100000100010101
1011101110101110111011111110101110101
1000101000001000000010000010101010001
1011101011101110101011111010101010111
1000001010001010101010000000000000001
1010111111101011111011111110111110101
1010001000101000100000000000000010101
1110111110101110101010101110101011101
1000101010000000001010101010101010101
1110101011101010101011101011111010101
1000000000001010101010000000001010001
1010101011101011101111101011101111101
1010101010001000101010001010000000101
1111111010111111101011101110111110101
1010001010001000001000000010000010101
1011101111111011101010111010101011101
1000000000000000101010100010101010001
1010101110101111101010101010101011101
1010101000101000001010101010101000101
1111101111101110111011101011111111101
1010001010001000101010001000000010101
1010101010111110101111101110101110101
1000100010001010000010001000101010001
1010101010111010111111111010111010101
1010101010100000000000100010100000101
1010101110111110111111111010111111101
1010101000101000000000001010001000101
1110101011101011101011111111101011101
1000101010100000101000000010000010001
1010111110101011111010111011111010101
1010100000001010100010100010001010101
1011111011101110101011101111101011111
1010000010100000101000101010100010101
1010111010111111111010111010101010101
1010100000100000000010000000101000001
1111111111111111111111111111111111111
