1111111111111111111111111111111111111
1010000000000010000000101010100000001
1010111111111010101110101010101010111
1000101000000000101000000010001010001
1110101110101111111110101111101010111
1010100000101000100010100010001010101
1010101110111110111011111011101111101
1000101010101010101000000000000000001
1010111011101010101110111010101110111
1010100000000000000000100010101010101
1011111011111011101010111111101010101
1010101000001010001010000010000010001
1110101110111011101011111111101010111
1000000000100000101000001000101010101
1011111110111111111011111010111110101
1010000000101000001010101010100000001
1111111011101011111110101110101011111
1010100000101000100010001000001010001
1010111111101011101110111111111010111
1000101000100000001000000000100010001
1110101010101010101010111010101010111
1000001010001010101010001010101010101
1110111110111011101111101010101010101
1000000000100000101000101010001010001
1111101110101111101110111110111110111
1010101000100010100000001000000000001
1010111111111010101111111111101111111
1010001000000000100010001000000000001
1010111110101111101010111111101111101
1000000010101000101010001010001000101
1110101110111011111010111011111010101
1010100000101010100000100000100010001
1010111111101010101110111110111110111
1000100000000000100010000000000000001
1110111110101111101011111011101010101
1000000000100000101000100010001010101
1111111111111111111111111111111111111
