1111111111111111111111111111111111111
1000000010000010000000100000000000101
1110111011101111111110101110111110101
1000100010100000100000001010000010001
1110111010101010111011111011111011101
1000101010001010001000000000101000101
1011101110111110111111101110101111111
1000000000100000000010001000000010001
1010111110101111101111111111101010111
1010000010101000100000001000001000101
1110111111101010111110111011101011101
1000000010001010001010001010101010001
1110101111111110111011101110101110111
1000100010000010100010000000000000001
1110111010111110101011101010101111111
1000001000001000101000001010101000001
1111101011111110111111101110111110111
1010001010100000000010001000100000001
1011111010101011101111101010111011101
1000100000101000101010101010100010001
1110101111111110101010111110101111101
1000000000101000101010000000001000001
1010101111101010111011101111111111101
1010100010001010000010001000100000101
1111111010111110101111101011101010101
1010001010101000100010001000101010001
1011101010101111101011111011111110111
1010000010001000101000100000001000101
1010111011101010111010101011101011101
1010101000000010100010101010001010001
1011101110111111101111111011101010111
1000001010001000000010000010000000001
1011101010111011111011111010101111101
1010000010001000001010000010101000101
1011111110111010101111101011111011101
1000000000000010101000001000100000001
1111111111111111111111111111111111111
