1111111111111111111111111111111111111
1000100000001000100000100010001000001
1011111010101011101111101111101011111
1010000010101010001000000000100010001
1011101010101011101011111110101110111
1010001010101010000000001000101000001
1011101111101011101011111111101110111
1000100010000010001010100010100010001
1011111111101111101110101110101110101
1000001000001010000010001000000000101
1011101111101011101110111110111110111
1010101010100000000000000000000010001
1110101010101110101110111010101011111
1000000000001010100010001010101000001
1010101111101011101110111111101110111
1010100010000010101000000010001010001
1111101111101110111110101111111011101
1000001000100000001010100000000000101
1011111110101111111011111111111110111
1000101000000010100010100000000010001
1011101110111010101110101011111010101
1010000000100000000010001000001010101
1111101011111011101110111011111111111
1000001010000010000000001000000000001
1111111111111011101010111111101010111
1010001010000010101010101000001010101
1011101010111010101011101111111111101
1000100000100000101000001010001000001
1011101110111010101110111010111010111
1000000010001010101000000000000010101
1110101010101110101110111010111011101
1000101010101000101000001010001000001
1111101110101110111010111011111011101
1010001010100010100010001000101010101
1011101010101110101011101011101010111
1000000010100010101010001000100000001
1111111111111111111111111111111111111
