1111111111111111111111111111111111111
1000001000000010000010001010001010001
1011101011101110111010101010101010101
1010001010001000001010100000101010101
1011111011111011111010111110101010101
1000000010000010001010100000101000101
1011111010111110101010101111101011101
1010100010000010100010100010100010001
1010101111111010111011111010111111111
1010001000001010001010001010000000001
1110101011101010101010101011101111101
1000101010101010101000101000001000101
1011111010101010101111111011101110101
1000100010100010100010000000101000101
1110101010111110111010111110101011101
1010001000001010001010001000101000001
1011111111101011101111101011101111111
1000100000000000100000001010001000001
1010101111111111111111111010111010101
1010001000001000000010001010001010101
1011111111101011111010101011101010111
1000001000001010000010100010001010001
1111101011111010111110101111111110101
1000101000000010001000101000000010101
1011101011111111101011101011111010111
1010001010001000101000101010001000001
1010111011101011101010111010101111101
1000100010001000101010001000100010101
1010101110101010101011101111101010101
1010100000101010101000100010101010101
1010111111101110101111111010101010101
1010001000100000101000001010001010001
1011101110111110101011101011111010111
1010100010100010101010000010001010001
1010111010101010101011111010101111101
1000001000001000101000001000100000001
1111111111111111111111111111111111111
