1111111111111111111111111111111111111
1000101010001000101010000000000000001
1110101010101011101010101110101011101
1000101000101000101010101000101000101
1011101111101110101010111111101011111
1000000000000000000000000010101000001
1011111010101010111011111010101010111
1010000010101010100000001010101010001
1010111011101010101010111010101111111
1010100000101010101010001000100000001
1010101110101011101111111110111111111
1010101000101010001000001010101010101
1011111011101011101110111010101010101
1010101010001000100000001000000010001
1110101011101011101010111111111110111
1000000010001010001010001010000000001
1110101011101011101110111011101111101
1010101010101000101000000000000000101
1011111110101111101110111110101111101
1000000000000000101000001010100010001
1111101011111110101110101010111110101
1000001000001000101000100010101010101
1110111010101110111110111110101011111
1000100010101000001000000010000000001
1010111111101111101010101111101010111
1010001000000010001010100000101010101
1011111111111011111010101111101011101
1000000000100010100010100010001000101
1010101011111010111010101110101011101
1010101010100000001010100010101000001
1110111010111011101011101010101010101
1000001000100010001000101010101010101
1110111011111011111110111111101110101
1010100010100000001000001000000010101
1010101010111010111010101111101110111
1000101000001010100010100010000010001
1111111111111111111111111111111111111
