1111111111111111111111111111111111111
1000000000101000100000100010101000001
1111111110101110111110101110101110111
1000100000000010001000100000000000101
1110111011111010101011111110111111101
1000001000100010101000101000001000001
1111101111101110101110101110101010111
1000000000001000101000000010100010101
1110101110101111101010111111111110101
1000101010100010001010101000100010101
1110101011111011101011101010111010101
1000100010101010001000000010001010001
1110101010101010111111111111101010111
1000101000100000100000001000100010101
1111101010101110111011101011101010101
1000101010101010100010000010001000101
1110101011111010111011101110101111101
1000101000000010100010000000101010101
1010101010111111111111101111101010101
1010101010101010001000000000101000101
1011101111101010101110111111111110101
1010000010000000100010101000100000001
1011111011101110101110101011101011101
1000000000000010100010000000101010001
1011101111101110111011101110101011111
1010001000101000100000000010101010001
1010111010101111111110111110111011101
1010101010001000100000100000000000101
1110101110111011111110111111101111101
1010001010100000100010100010100000001
1010101011101111101110111010111010111
1010101000001000001010001000100010001
1011111110111010111010111110111110101
1000000010001010101010001010000000101
1011111011101110101010111010111111101
1000001000000000000000000010001000001
1111111111111111111111111111111111111
