1111111111111111111111111111111111111
1000000000000000000000000000000000001
1010111011101011101010111110111110101
1010001000101010001010100000100000101
1110101010101010101110111110111010101
1000101010101010101000000010001010101
1111101110111011111011101111101111101
1000000010001000001010001000000010001
1010101010101011111110101111101111101
1010101010101000000010100010000000101
1011111011101110111010101111101010111
1010000000100010100010100000101010001
1010101011111110111010101011101011101
1010101010000000001010101000101000101
1011101010101010111111101011101110101
1000101010101010100000001000101000101
1111111111101011101111101011111111101
1000000000001000101000001010000000001
1011111011111011101110111011111110101
1010000010000000101000100000001000101
1011111011111110111111111011101111101
1000100000100000000000100010001000001
1010111111111110101010101011101110101
1010000000100000101010101000100010101
1111101011101111101111101110111010111
1000001010001000001000000010100010001
1010111111111011111111111111111110101
1010100000000000001000000000000000101
1011101010111111101010111011101110111
1000101010100000001010001010000010001
1110111111101111101110101110111111101
1000100000000010000010100010001000001
1010111110111011111110101111101010101
1010001000100000000010100000101010101
1011101011111010111011101011101110101
1010001000001010100000101010001000101
1111111111111111111111111111111111111
