1111111111111111111111111111111111111
1000000000000000000000000000000000001
1011111010111011101010101111111011101
1000001010100010001010100000100000101
1010111111101010101011111110111011101
1010100000001010101010000000001010001
1111101011101010111110111010111110101
1000001010001010000010100010000010101
1110101110101011111010101011101110111
1000100010101000001010101010000010001
1010111110111011101111101110101010111
1010100000100010000000101000101010001
1010101011101110101011101011111110101
1010101010000010101000101000100000101
1011101111111011101011111110111010101
1010001000000000101000001000100010101
1110101010101011111110101011101011101
1000101010101010000000101010001000101
1111101010111110101110101111101111111
1000001010000010101000101000000000001
1011101111111110101011101010111011101
1010000000100000101010001010001000101
1110111111101010111010101111111111101
1000001000001010100010100000100000001
1110111010111110101110111110111111111
1000001010100000101000000010000000001
1010111111101111101011101111111011101
1010100000001000001000100000001010001
1010101111111010101110111011101110101
1010100000100010101000001000100010101
1110101010101011101011111111101110111
1000101010101000101000000000101000001
1011101011111111111111111110101011101
1010001000000010000000000000101010001
1011101010101010111010111011101110101
1010001010101010001010100000100010101
1111111111111111111111111111111111111
