1111111111111111111111111111111111111
1000100000100010001000000000101000101
1011101011101010101011111110101010101
1000101000101000101000000010000010001
1010101110111110101111111011111010111
1010100010000010101000001010001010001
1110111010101110101011101010101111101
1000001010101000101000100010100000101
1011101011101011101111111110111011101
1000100010001010001000100010001010001
1110111110111010111010101011101110101
1000100010000010001010001000001000101
1011111010111111101011111111111011101
1000000010000000101000000000100010101
1011111111111110101111111110101110101
1010000000001000101000100000100010101
1011111110111010101110101111101010101
1000100010000010100010101000001000101
1110101011111111111010101011111111101
1000101010000010001000100010001000101
1110101011111010101010111110101010101
1000101010001010101010000000101010101
1011101010101010101111101111111010101
1010001010101010101000000010000010001
1010101011101011101011111010111111101
1010101000001000001010100010001000101
1010101111101110111010101111101011101
1010101000100010000010100000101000001
1011101011111011111110111110101110111
1000001000000010000010000000100010101
1011111111111010111011111011111010101
1000100000100010100010001000001010101
1110101111101110111110101111111010101
1000001010001010000010100000000010001
1011111010111011111010111110111111111
1000000010000000000000100000000000001
1111111111111111111111111111111111111
