1111111111111111111111111111111111111
1000100000001000001010000000000000001
1110101011101011111010101110111111111
1010101010000000100000101010000000101
1010101111111011111111111010101111101
1010100010000000001000100000100000101
1010101111111011111010111011101010101
1000101000000000101010001000101010001
1110111111111010101110101011111111111
1010101010001010100010101010000000101
1010101011101011111011101010111111101
1000000000000000100010000010001000101
1110111011111110111011101110111011101
1010101010000000000010001000101000001
1011101111111010111011101011101110111
1000000000100010100000000000000000001
1111101110111110111111101111101110111
1010101000101010100000001000101010001
1010101110101011111110101110101011101
1010101010001000101000100010000010101
1010111010111110101111101111111110101
1000000000000000000000000010100000101
1011111011101110101010101010101111101
1010101010001000101010101000000000101
1010101010101111111010101011101011101
1010000010101010000010101010001000101
1011101010101011111110101111101011111
1010001010100000001010100000101000001
1011101111101111111010111011101011111
1010001000001000100000101010101000001
1011101110101011111110101010111110111
1010001000100000001000100000001000001
1010101111101010111111101010111110101
1010101000101010001000001010001000101
1011111011101110111010101110101110111
1010000000000010100010100010101000001
1111111111111111111111111111111111111
