1111111111111111111111111111111111111
1000100010000010000000001010001000001
1010101010111011111011101010101010111
1010001000100010001010001010100010001
1011111111101110101110111010111110101
1010000000100000100010100010001000101
1010111110111111111010101011101111101
1010001000100010000010001000100000101
1010101011111010111110111111111110101
1010101000001010001000100010001000101
1010101111101011101011111010101011101
1010101000100010000000001000100010001
1010101110111110111111101110111110111
1010100010000000101000100010001010001
1010111011111110101010111011101011101
1000001000100000100010100000001000001
1111101110101111111011101111111010111
1010001010100000001000001000101010001
1010111010111111101111111010101011101
1000100010100000101000001010101000101
1111111010101110101011101010101110101
1000001010001000100010000010100000101
1010101011111011111110111110111111111
1010100010001010001000100010000000001
1011111110111010101011111011111110101
1000000010001000101000001010001000101
1110111010101111101111101010101111101
1000100010100010101000101000100000001
1010101111111010101010101111111111101
1010100010001010100010100000000010001
1010111010101010111110111011111010111
1010101000100010100000100010001010001
1010101110111110111110111110101011111
1010101010000000100000100000101000001
1010101010101111101111101111101111101
1010000010100000001000000000100000001
1111111111111111111111111111111111111
