1111111111111111111111111111111111111
1000001000100000100000100010001000101
1011101110111010111110101111101010101
1010000000000010100010101010001010101
1111101111111011111010101011101011101
1010101000000010100010100000101010001
1010111110101010101110101111101011101
1000100000101000101000001000000000001
1110111111111110101111101110101110111
1000001000000000001010001010101010001
1111101111101111101011101011101011111
1000000010101010101000001010101010001
1111101110111010101110111010101011101
1010000010100010100000100010000010001
1011111010111010101010101011111011101
1010001010000000001010001010000010001
1011101011101111101111101111111011101
1000101000100010001010000000101010101
1010101011111110111011111110101010101
1010001010000010001000001010000000001
1111101010101011111111101010111110111
1000000010101010000010000010100000001
1110111111111011101011101011111010111
1000000000100010101010101010101010001
1110101110111010111010101110101110111
1000101010000010101000000010000000001
1111111011111010101011111011111110111
1000000000100000001010000010100010001
1110111110101010111111111010101110111
1000100000001010100000001000100010101
1011111011101110101111101010101110101
1010001010101000000010001010000000001
1110111010111110111111101111111010101
1010000010000000001010000000001010101
1010111111101010111011111011101110111
1000100000001010100000000010000000001
1111111111111111111111111111111111111
