1111111111111111111111111111111111111
1000000010000000001000000000000010001
1011111110111011101111111011111010101
1000001000001010000000000010001000101
1011101011111010111111111111101111101
1000100010000010100000000000100010001
1110111110111110101111111110111010111
1010100000100010101010000010001000101
1010101111101110101010101111101011101
1010101000000000101000100000101000001
1010101111111111101111111011101111101
1010100000001000001000000010001000101
1010111111101011111011111110111011101
1010100000100010000010001000100010001
1010101110111110111110101011101010111
1000101000000000100000100010001010001
1011101011101111101111111110101011101
1000101000101000100010000000101010001
1110111110101010101011111111101110111
1010000000101010101010001000100000101
1011111011111010101010101010101111101
1010000010001010101010101010100000001
1010111110101010111010101010111111111
1000000010100010001000100010000000001
1011111110111111101011111111111111101
1010000000100000101010000000001000001
1110111111101110101010111111101011101
1000100000101010001000100000101000101
1011101110101011111111101110101110111
1010001000101000001000000010000010001
1011111010101011111011111111111111101
1010000010101000000000100000000000001
1010111111101111111111101111111111101
1010000000000000000000001000001000101
1011111111111111111111111010111010101
1000000000100000000000000010000010001
1111111111111111111111111111111111111
