1111111111111111111111111111111111111
1000000000000000000000000000000000001
1011111010111010111110101111111111101
1000100010100010000010100000000000101
1010111111101111111111101010101010101
1010100000000000001000001010101010101
1010111110111010101011111110111010111
1010001000100010101000100000100010001
1110111011101110101110101010101011111
1000100010001000100010101010101000001
1010111011101011101011101010101110101
1010001000101000101000101010101000101
1011101110101011101011101111101011111
1010000010101010001000100010001000001
1011111110111110111010111011101111101
1000001000000010100010001000100000101
1010111110111010111011101110101111101
1010001000001010100010001000100010001
1010101110111110101110111011111110111
1010101000100000101000001000100000001
1010101111101010111011111110101110101
1010101000001010100010000000101000101
1110111011111111101010101010101010111
1000001010000000001010101010101010001
1010111010101110111111111110101010101
1010001010101000000000001000101010101
1111111110111110111110101110111111101
1000000000000010100000101000100000001
1110111110101110111010111111101111111
1000001000100010100010000010000000001
1011111010101111101110111111111111101
1000001010101000000010001000000000001
1111101010101111101010101110111011111
1000001010101000001010100010001000001
1011101110111010111110101110101010101
1010001000001010100000101000101010101
1111111111111111111111111111111111111
