1111111111111111111111111111111111111
1010001000001000101010101000100000001
1010111111101011101010101011101111101
1010000000100010000000000000001000001
1011111110111010111010111110101110101
1000000010000010001010100010101000101
1110101010111011101110101111111111101
1010101000100000000010100010001000001
1011101111101110111110111010101111101
1000001000001000100010100000101000001
1111111110111110101111111111101110101
1000001000100000001010100010101000101
1111101011111110111010111010101010111
1000000010000000000010101000100010001
1010111011101111111110101110111110101
1010100010100010001000000010000010101
1111111010101011101011111111101110101
1010000010001010000000000000101000101
1011111111101111101010111110101111101
1000001000000010001010000010000010001
1010101110101110101111101111111010101
1010100010100010101000100010100000101
1111101111101110111011101110111110101
1000001000100010100010101000100000101
1111101011111010111010111110101011101
1000100000000010000000001000101000101
1010111111111011101111111011111011111
1010001010101000100000100010000000101
1110111010101110111011101111111011101
1000000000101010100010000000100000001
1111111110101011101011101110101010111
1000000010001000001000100010001010101
1110111010111111101110101111101111101
1000001000001000001010100000101000001
1011101010101010111011111011101010101
1000101010100010001000000010000010101
1111111111111111111111111111111111111
