1111111111111111111111111111111111111
1000001000000010000000000010000000001
1110101010111011111111111010111110111
1000101010100000000010000010100010001
1011111010111111111010111110101111101
1000000010000000100010000000100000001
1111111111111110101111111111101111101
1000000000100000100010000000001000001
1011111110101111111011101111111111111
1010001000100000001000000000000010001
1010101111111111101111111111111010101
1000101000001000001000000010001010101
1011101011101011111110111011101010101
1010001000101000000000100010001000101
1010111010111110111111111110111111101
1010001010000010000010000000001000001
1011101111101111111010111111101011111
1010100000001000000010000000101010001
1010111110111010111110111111101011101
1000101000101010100000100000001010101
1011101011101011101111101111111010101
1010000000001000001000100000001010001
1010111111111111101110101111101010111
1010001000000000001000101000101010001
1011101111101111111011101010111011101
1000101000101010001000101010001010001
1111101010101010101010101011101010111
1000101010100010101010101010001000001
1010101010111010101010101010111111111
1010101010100010100010001010000000001
1010101010101110111110101111111111101
1010001010101010000010100000000000101
1011111010101011111010111111111110101
1010000010100010100010001000001000101
1010111011111010101111101011101011101
1000001000000010001000000010001000001
1111111111111111111111111111111111111
