1111111111111111111111111111111111111
1010000010000010000010000010101010001
1011101110111011111011101010101011101
1000000010100000001000101000100000001
1110111010111111111110101111111010101
1010100010000010100000001010001010101
1010111010101110101011111010111011111
1010001010101000001000000010000000001
1011101010101011101110101110111111111
1010001000101000100010100010000010101
1010111011111110111110101110111010101
1000101000101010000010100000101010101
1111101011101011111010111010101110101
1000100000100000101010101010000000001
1011101110101011101110101111111110111
1000000010001010000000001000101000001
1110111010111011101110111011101011111
1010001010100010001000100010001000001
1011111111111011111110111010101011111
1000100000101010001000000000101010101
1010111010101010111111101110101110101
1010100010101010000000001000100000001
1010101110101010101110101011111111111
1010001000001000101010101000000000001
1011111011101011101010101111101111111
1000100010001010101000101010101000101
1110101010111010111111101010101011101
1000101010001000000010101000100000001
1111111011111111101010111110101111111
1000000000100000101010100000100010001
1110101110111010101110101111101010101
1000100010000010100000000000101000101
1011101111111010101110101111111011111
1010100010100010000010101000001000001
1010111010101111101110111111101011101
1010000000100000101000000000001010001
1111111111111111111111111111111111111
