1111111111111111111111111111111111111
1000001010001000101000000000100010001
1110101010101010101010111110101010101
1000101010100010100010100010101000101
1011101010111110101110111010111011101
1010001000100000101000100010001010001
1011111111101111111011101011101110101
1000001000001000000010001000101000101
1011101011111011111110111110101011101
1010100010001000000010101000101010101
1010111111101011111010101011101010101
1010000000100010100010100010001010001
1010111110111010101110111010111011111
1010001010001000101010001010001010001
1011101011101111101010101111101010101
1000001000100000101000100000101000101
1111111110111110101011111110101110101
1000001000100010001000001000100010101
1110101010101011111111101011111011101
1000100010101010000000101000001000101
1011111011101010111110101110111110101
1010001010001000101000101010100000101
1010111010111111101011101010101111101
1010000010100000101000101010101000001
1011111110101110101110101010101010101
1000100010101000000010100010001010101
1110101010101111111010111011111110101
1000101000100010100010001000000000101
1010101111111010101110111111111111101
1010101000000010101010000000001000001
1011101011111110101011111011111011111
1000001010000000101010001010000010001
1011111010111011101010101010111111101
1010000010101010001000101000100000101
1010111110101010111111101111111010101
1000100000001000000000000000000010001
1111111111111111111111111111111111111
