1111111111111111111111111111111111111
1000000000101000000010000000000010001
1110111110101010111111111011101011101
1000000010000010001000000010001000001
1110101110111110111111111110101111101
1000100010101010000000100000101010001
1011111110101011111010101110101011101
1010101000101000000010100010101000001
1110101110101111111111111111111011101
1010000000100010000000000000000010001
1011111110101111101011101110111110101
1010000010100000101000101000001000101
1010101110101010101110111111101110111
1000100000001010100010100000000010101
1010111010101110101010101011101110101
1010100010101000001010101010101010101
1011101110101111111011111110101011101
1010100010101010001000001000001000001
1110111110101010101111101110111011101
1000000000100000101010001000000010001
1011101111101111111011111111101111111
1010001000101010101000001000000010101
1110111110111010101010101011101010101
1010000010001000001010101010001000101
1011101010111011101110101010101110101
1010001000000010000000101010100010001
1010111110101111111010111111111011111
1000100000101000001010100000100010001
1110111010111011101011111110111110111
1010100010001010100010100000000010001
1011111011111110101110111011111011101
1000001000000010100000000000101000101
1110101011111010111110111111101011101
1000100000101010000010001000100000001
1010101010101111101110101010101111101
1010101010100000000000100010100010001
1111111111111111111111111111111111111
