1111111111111111111111111111111111111
1000001000101000100000100000000000001
1011101010101010101111101111111011101
1000101010001010001000001000100010001
1110101011101011111011111010111110111
1000101010001000100000001010000000101
1011111010111010111111101111111111101
1010001010001010100000000010000000001
1010101111101110101110111011111011111
1010100000100000100010001000000010001
1010111110101011111111111011111010101
1000000010101000100000001010001010101
1011111010101110101111101011101010101
1010001010001000100010001010001000101
1110111011111111111010111010101111101
1000100010000000000010100010101000101
1011101110111111101110101110101010101
1000101000000010001000100000101010101
1010101111111011111011111111101010101
1010101000001010001000100010001010001
1110101011101010111110101010111111101
1000100000101000100000101010000000101
1011111110101110101011101011111110101
1000000010100010101010001000001000101
1110111110111010101110111111101011101
1000100010001010100000100000101000101
1011101011101110111111101110101110111
1010001000000000000010001000101000001
1010111111111111101110111011101111101
1010101000000010001000100010001000001
1010101011111010111010111110111011101
1000100010001010100010000000100000101
1111101110101011101111111111101110111
1010001000101010001000001000100010001
1010111011101110111011101110111111101
1000000010000000000010000000000000001
1111111111111111111111111111111111111
