1111111111111111111111111111111111111
1000000000000000000000000000000000001
1011111111111011101010111110111011101
1010000000000000101010100000001010001
1011111010111011101111101111111010101
1000100010100000100000101000000010101
1011101111111011111010101110111110111
1010001000000000100010101000000010001
1011111011111110111010101010101011111
1000100000000010001010101010101000001
1110111010101010101111111110101110111
1000100010101010100000000010100010001
1010101011101110111010111011111010101
1010101000101000001010100000001010101
1010111110111111101110101110111011101
1010001000001000001000100010100010001
1010111111111010111110111111101011101
1010000010000010100000001000001000101
1010101111101111101111101011111010111
1010100010000000101000001010000010001
1010111010111011111011101011101011101
1010100010100010000010001010001000101
1011111110101110111010111110111011101
1000000010101000001010001000100000101
1010101011101110111010111010101010101
1010101000101000001010100010101010101
1110101010111111101011111010101011101
1000101010001000001000100010101000101
1110101010101110111010111110111010101
1000101010101000001010001000001010101
1111101111101010101111101110111110101
1000000010001010100000100010100000101
1011101110101010111010101011101011101
1010000010101010001010101000101000101
1010111110101011101011111110111010101
1010100000101000101000001000001010101
1111111111111111111111111111111111111
