1111111111111111111111111111111111111
1010101010101000000010000000100000101
1010101010101011101010101110111010101
1010000000100000101000101000000010101
1011101111101111111111111111111111101
1010000010100000001000100010001010101
1010111010111011111110101110101010101
1000001000100010001000100000100010101
1010101010101111101110101111111010101
1010101010101010001000000010000010101
1111101111101011101111111110111110101
1000000000100000000010000000100010101
1011111111101110111011111010101010101
1000000010100010001000001010101010101
1011111110111110111010101010111010101
1000101000000000001010100010100010101
1010101010111010111111111110101110101
1010000010100010001000000000100010001
1010111010111011111110101111111010101
1010001010100000001000100010000010101
1110111111101011101110111010101110101
1010001000101000101000100010100000101
1011101011101110101011101010111010101
1000000000101000101000101000100010101
1011101110101111111111111111111111111
1010001000100000000000000000000000001
1110111110111111111111111111111110111
1000001000100000000000000000000000001
1111111111111111101111111111111111111
1000101010000000100010001000001010101
1010101010111110111010111011111010101
1010001010001000101010001000000010001
1011111011101011101010111110101011101
1000001000001000000010001000101000001
1010111110111011101111101110111010111
1010000000001000100000000000001010001
1111111111111111111111111111111111111
