1111111111111111111111111111111111111
1010000000101000100000101000000000101
1010101010101011101011101010111110101
1000101010100010101000101010001000001
1010101111101010111011101110111111101
1010100000001000100000001000001010001
1010101111111110111110101011111010111
1010100000100000100000101010001010001
1010101111111111101010101011101010111
1010100000000000101010101000001000001
1010111010111010111011101111101111101
1010100010100010000000101000001000001
1111111111111110111111111011111111111
1000000000000000000000001000100000101
1111111111111011111111111011111110101
1000001000100010101000001000100000101
1111101110101010101111101010111110101
1000001000101000101000100010001000101
1011111011111110101010101011101011101
1010001000100000001010001000101000101
1010101011111110101011101011101110101
1000101000000000101010001000100000001
1110111111111011111111101011111111111
1010001000100010001010001000000000001
1010111011111010101011101111111111101
1000000000001000100000001000100010001
1010111011101011101110111010111010101
1010001000100010001000001010000010101
1111111111111111101111101010101110101
1000000000100010101000001010100000101
1111101110101010101111101011111111111
1000101000001010001000101000000010101
1011101111111011101011101010111010101
1000001000000000001000001010001000101
1110111010101010111011111010101010101
1000001010101010001000001010101010001
1111111111111111111111111111111111111
