1111111111111111111111111111111111111
1000000000000000000000000000000000001
1011101011111010111110111011101011101
1010001010000010001000001000101000101
1010111010101111101011111010101010101
1010001010100000101000100010101010101
1010111110101010111110101010111010111
1010001000101010100000101010001010001
1011101010101111111111111010111011101
1010001010100000000000001010001010001
1111101011111010101110101110111110111
1000001000001010101000101000001000001
1011111110111110111011101111101111101
1010000000001000100000101000000010001
1111101111111110101011111011111010111
1000000000001000101000100000001010001
1010101110111010111111111010101011111
1010101000001010000000100010101000001
1010101011101011111111101011111011101
1010101010001000000010001000001000101
1011111110101111101011101111111010101
1010000000100000101000100010000010101
1010101111111110111110111010111110101
1010101000000000000010001010000010101
1010111111111011111110101110111110101
1010001000000000001000101000001000101
1011111011101111111110101011101110111
1000100000100000100000101010000010001
1111101110101011101110101010111011111
1000000010101010001000101010100000001
1011111110101011101110101110111010111
1010000000101010001000100010100010001
1110101011101010101110101010101010101
1000101000101010101000101010101010101
1011101010101111101011101011111111101
1010001010101000001010001000000010001
1111111111111111111111111111111111111
