1111111111111111111111111111111111111
1000000010000010000000100010000000001
1010111110111010111110101011101111101
1010100000101010001010001000100000101
1011101011101011101010111110111110101
1010001010100000101010000010001000101
1010111010101110101011111011101011111
1010001010101000101010000010100010001
1011101010101111101010111110111110101
1000001000100000000010100010000010101
1111111110111111111110101010111010101
1000000010000000001000101000100010101
1111101111101111111010111111101110101
1000101000100010000010100000001000101
1010101010111010101111101111111011101
1010001010100010100000001000001000101
1011111010101110111111101011101011101
1010000010001010100000100000101010001
1010111110111010101111111111101010111
1000100010100000101000000010001010001
1111101110101111101011111011111010101
1000101000100000100000100010100010101
1010101011101110111110101110101010111
1010100010100010000000100010101010001
1011101110111011111111111010101111101
1010000010001010100010000010001000101
1010111111101010101010111111111010101
1000100000100010001000100000100010001
1011111110111110111110111110101111101
1010000010000010000010000010000000101
1011111011111011101111111010111110101
1000000010001000100000001010101000101
1110111110101011111111101010101011111
1010000010101000001000101010101000001
1010111010101011101011101010101111101
1000001000100010001000001000100000001
1111111111111111111111111111111111111
