1111111111111111111111111111111111111
1000001000000000100000100010000010001
1011101011111010111010101010111010101
1000100010000010100010101010101010101
1110111110111110101110101010101010101
1010100010100000100010001000101000101
1010101010111110111011111111101111101
1000101010000010000010001000100010001
1011101011111011111010101010101110111
1010001010001000101010100010100000001
1010111011101110101010111110111111111
1010001000000010100010001010000000001
1011101111111010111111101011111111101
1000100000001010100000001000100010001
1110111110101110101111111010101110101
1010000010100010001010000010001000101
1011111011111011111010101111101011101
1010001000000000100000101010001000101
1010101111111110101111101010111110111
1010100000100000100000101000000010001
1010111011101111111111101011111111101
1000101000001000000000001010000000001
1011101111111110111111111010111111101
1010000000000000100010000010100000101
1011111011111011101011111110101010101
1000001000001010001000100000101010101
1111101111101010111110101111101011101
1010001000001010001000100010001000001
1010111011111010111010111011101111111
1000101010001000100010001000100000101
1011101011101111101111111110101110101
1010000000000000100000001000101010001
1011101111111011111111101011111011101
1000101000001010001000101000001000101
1110111011101110101010101111101110101
1000000010000000100010000000100000101
1111111111111111111111111111111111111
