1111111111111111111111111111111111111
1000101010100000101000101010100010101
1110101010111110101110101010101110101
1000000000100010000000000010000000001
1111111011101111111110111011111011111
1010100010101010100010001010001010001
1010111010101010111010111110111011101
1000101010101010100000101010001010001
1110101010101010111010101010111010101
1010100000001000001010100000101010101
1010111110111011111011101011101011101
1010000010001000100010101010000010001
1011101110111011111010111010111111101
1010001000000010100000100010000010001
1010101011101110101111101011101110111
1010101010000000001010001010101010101
1011101111101111101010111110101010101
1000000010101000100010100000000000001
1010111010111011101110101011111010101
1010101000001010101010001010101010101
1111101110111010101010111110101111101
1010000000000000000000001000000010101
1011111011101010101110101011111110101
1010100010001010101000101010000000101
1010111110101111111110111010111111111
1000100010101010000010001000000000001
1010101111111011101110101011111111111
1010001000100010101000101010100010101
1111101011111010101011111010101110101
1000000010000000000000001000100000001
1111111011111111101011111011111011111
1000101010100000001010001010001000001
1110101010111011111010111011101011111
1000000000001010000000000010001000101
1111101110111111111011111011101011101
1000001000000000000000001000000000001
1111111111111111111111111111111111111
