1111111111111111111111111111111111111
1000000000000000000000000000000000001
1011101110111111101111101011111110101
1000101000000000101000001010000000101
1110101011101010111111111011101010111
1000101000101010100000000000101010001
1011111011101110111010101010111111101
1000100000101000001010101010000000101
1010111110111011101010111111111011111
1010000010100010001010000010000000001
1010101110101110111110111110111110111
1010100010101000000010000010100000001
1011111110111010101110101110101010101
1010000000100010100010100010101010101
1111101110111010111011111111101111101
1000001000001010100000000000101000001
1010111111101011111011101111101111101
1010100000001000001010000010000010001
1010101110111111111111111111101111111
1010101000000000001000000000000000001
1010101111111110111011111011101011111
1010100000000010100000001000101000001
1111101010111011111011111111101011101
1000001010100010000000000010001000101
1010111011101010111110101110101010101
1010100010001010100000100010101010101
1110111010101010111110101011101110111
1000001010101010000010101010001000001
1111101111101011111111101110101011111
1000000000101000001000001000101000001
1110111010111011101010111110111010101
1000001010001010001010100000001010101
1011101011101110101110101010101110111
1000101010001000100010101010101000001
1111101110101010101111111011111010101
1000001000101010101000000010000010101
1111111111111111111111111111111111111
