1111111111111111111
1000000000100010001
1011111110111011101
1000001000100010001
1011101111101110111
1010100010000010001
1010111010101011101
1010001000101010001
1010101111101010101
1010101000101010101
1011101011101011101
1000101000101010001
1110101011101010101
1010101000101000101
1010101011101111101
1010001000001000101
1011111111111011101
1000000000000000001
1111111111111111111
