1111111111111111111
1010100000001000101
1010101111111010101
1000101010001010001
1011101011101110111
1000001000000000001
1111101011101010101
1000100000101010101
1010101010111110101
1010001010000010101
1110111010111110111
1000100010001010001
1110111111111010101
1010100000001000101
1010101110101010111
1000001010101010101
1011101010111011101
1010000010001000001
1111111111111111111
