1111111111111111111
1010001000001000101
1010111110111110101
1000000000000000001
1010101010111111111
1010101010000000001
1011111110101110111
1010100000100010001
1010101110111111111
1000101010001000101
1010111010111011101
1010001000000010101
1010101110101110101
1010101000100010001
1111111110111110101
1000000000000000101
1011101011111010111
1010001000100010001
1111111111111111111
