1111111111111111111
1010000010000000101
1010111010111110101
1010001000100010101
1011101111101011101
1010001000101000001
1010111010101111101
1010100010001000101
1010101111111010101
1010101000100010001
1010101110101111101
1000100000100010001
1011111110111010111
1000101000100010101
1110101011101110101
1010100010001010101
1010111110111010101
1000000000100000001
1111111111111111111
