1111111111111111111
1010100010100000001
1010101110111011111
1000101010100000101
1110101010101111101
1000000010000010001
1111101111111010111
1010001000101000001
1011101010101111101
1000000010100000001
1110101011101111111
1010101000101000001
1011101110101011101
1010100010100000101
1010111010111110101
1000100010000000101
1110101111111110101
1000000010000000101
1111111111111111111
