1111111111111111111
1000001010001000001
1011101010101111101
1010000010100000001
1011111110111111101
1000100010001010001
1110101011101010111
1000101000101010001
1011101110101011101
1010001000101000001
1010111011101011111
1010001010001010001
1011101010101011101
1010001010101010001
1010111010111010111
1010001010001010001
1011101011101011101
1000001000001000001
1111111111111111111
