1111111111111111111
1000001000100000001
1110101110101111101
1000100010101000001
1011101010101111111
1010001000100000001
1010111111111010101
1010100000001010101
1011101011101010101
1010001010001010101
1010101110111010111
1000101000100010001
1110111011101111101
1000100000001000101
1111101111111010101
1000001000101010101
1011111010101010101
1000000010100010001
1111111111111111111
