1111111111111111111
1000100010000010001
1011101011101110111
1000101010100010001
1110101110101010111
1000001000001010001
1111101111101011101
1000000000101000001
1110111110101011101
1000101010001010001
1110101010111011101
1000101000100010001
1111101111101111101
1000000010001000101
1011111010101010111
1000100000100010001
1010111010101010101
1010100010101010101
1111111111111111111
