1111111111111111111
1000000000000000001
1010111110101110101
1010001000101000101
1110101110111011101
1000101000100000101
1011101110101011111
1000101000101000001
1011111011101010111
1010000000101010001
1010111111111010101
1010100000000010101
1010101110111010101
1010100010001010101
1110111011111110101
1000001000001000101
1011101011101011101
1010001000101000101
1111111111111111111
