1111111111111111111
1010100000000000101
1010101111101111101
1010000010100000001
1011101110111010101
1000101000000010101
1110111110111110111
1000000000101000001
1111111110101111111
1010101000000000001
1010101111111010111
1000000000001010101
1111111010111011101
1010000010000000101
1010101111111011101
1000101010000000001
1110101011111011101
1000101000000000101
1111111111111111111
