1111111111111111111
1000000000000000001
1011101110111011101
1000101000100000101
1011101111101110111
1010000000101000001
1011111111101111101
1010000000000010001
1110101010111111101
1000101010001000001
1010111110111110111
1010000010100000001
1010101011101110101
1010101000101000101
1010111011111111101
1010100000000010001
1111101011111110101
1000001000001000101
1111111111111111111
