1111111111111111111
1000000000001000001
1011111111101011101
1000000010001000101
1111111011111111101
1000001000100000101
1011101110101110101
1010001000100010001
1110111010111110101
1000001010100000101
1011101011101111111
1010101000001000001
1010101110111011101
1000100010100010001
1110111010101110111
1000101010101010001
1011101010101011101
1000001000001000001
1111111111111111111
