1111111111111111111
1010101010100010101
1010101010111010101
1010000000001000001
1010101110111011101
1010101000100010001
1011111110111011101
1000101000101010001
1011101110101110111
1000000000000010101
1011111110111110101
1010100000000010001
1110111110101010111
1000000000101000101
1111101111111110101
1000101000000010001
1110101110111011101
1000001000100000001
1111111111111111111
