1111111111111111111
1010001010000010001
1010101011111011101
1010100000100010001
1010101110101110111
1010100010100000001
1010111010101011101
1010100010001010001
1011111111111011111
1010100000000000101
1010111010111111101
1010100010100000101
1010101110111110101
1010100010100000101
1010111010101010101
1010000010001010101
1010101110111110101
1000100010100000001
1111111111111111111
