1111111111111111111
1000000000000000001
1111111111111110111
1000100000100000101
1110101110101010101
1000100010001010001
1011101110111010111
1000100010101010001
1110111010101011101
1000100010001010001
1011111111111011111
1000100000000000001
1010101110111011101
1010001000100010001
1110101110101010111
1010101000101010001
1010101110111011101
1000101000100010001
1111111111111111111
