1111111111111111111
1000000000000000001
1011101110111011101
1010000010100000101
1010111011111011111
1010100000001000001
1110111010101010111
1000001010101010001
1111101011111111101
1000001010000000001
1011101010101010101
1000101010101010101
1011101011111110111
1010001010000000001
1011101010111110101
1010001010000010101
1011101110111110111
1010001000000010001
1111111111111111111
