1111111111111111111
1010001010000000001
1010111011101111101
1000101000001010001
1010101011101010111
1010000010001000001
1011101111101110101
1000100000101000101
1011111011101011101
1010000010001010001
1011111110111111101
1010000000100000001
1010111011111111101
1010101000000000101
1111101111101011101
1000101000101010001
1010101110101010101
1010000000001010101
1111111111111111111
