1111111111111111111
1000100000100000001
1010101111101111101
1010101000000010001
1110101011111011111
1010001010000010001
1011101010111110101
1000100010000010101
1010111111111010101
1010001000100010101
1110101110101110101
1000100000100000101
1011111111111111101
1000100000000010001
1110101011111010111
1000101000001000101
1011101111101011101
1000001000001000001
1111111111111111111
