1111111111111111111
1010000000001010001
1011111111101010111
1010000010000000001
1011101110111010111
1000100000100010001
1011101110101110111
1000000010101000001
1010111111101111101
1010000010000010101
1111101111101110111
1000100010000000001
1110101010101110101
1010001010101000101
1010111111111010111
1000001000000010001
1011101111101110101
1010001000000010101
1111111111111111111
