1111111111111111111
1010000000101000001
1010111110101011111
1000000010100000001
1110101111101011111
1010101010001000001
1011101010101111111
1000000010101010001
1010111110111011101
1010000010000000001
1111111010111011101
1000100000100010001
1010101011111111101
1010001000001010001
1011101111111010111
1000100010001010001
1110101110101010111
1000100000101000001
1111111111111111111
