1111111111111111111
1010101000101000101
1010101011101011101
1000001000000000001
1010101011101110101
1010100000101000101
1111111011111111111
1010000000000000101
1010101111101110101
1010100010000010101
1010111110101110101
1000000010100010001
1010111010101010101
1010100010101010101
1010111010111111101
1010100010000010101
1010111110101010101
1010000010101000101
1111111111111111111
