1111111111111111111
1000000000000000001
1011101111101010101
1000101000001010101
1110101010111111101
1000101010000000101
1011111010101110101
1000001010100010101
1010101111101111111
1010101000000000001
1010101110101011111
1010100010101000001
1110111010111011101
1000001010100010001
1110101010111110111
1000101010100000001
1010101111111011111
1010100010000000001
1111111111111111111
