1111111111111111111
1000100000100010001
1011111011101110111
1000000000000000101
1011101011111110101
1010001010001010101
1111101111101010101
1000101010100010101
1110111010101110101
1000101000001010001
1010101011111010111
1010100010100010101
1011101110101010101
1010101000001000001
1010101111101111101
1010101010001000001
1010101011111011111
1000000000000000001
1111111111111111111
