1111111111111111111
1000000010000000001
1011111010111111101
1010001000100000101
1010101111101110111
1000101000100010001
1111101011111011101
1000100010000010001
1110101110111111101
1000001000100000001
1011111011101010111
1000001010101010001
1110111010101011101
1010100010001010001
1010101110111010111
1010001000100010101
1011111011101111101
1000000010000000001
1111111111111111111
