1111111111111111111
1010001000101000001
1010101010101110111
1010100010001010101
1011101111111010101
1010101000001000001
1010101011101111101
1010100000101000001
1010101011101011101
1010001000101000101
1010111110101110101
1000100000101000101
1111111110111111101
1010100000000000001
1010101011101011111
1000001010001000001
1011111111111111111
1000000000000000001
1111111111111111111
