1111111111111111111
1000100000101000001
1010101010101010111
1010001010000010101
1111111110111110101
1000000000001010001
1110111010101010111
1010100010100010101
1010101111101110101
1000100000100010001
1111111111111010111
1010100000100010001
1010111011101110111
1000100000000010001
1110111011111010111
1000001010100010001
1011101010111011101
1000100000100010001
1111111111111111111
