1111111111111111111
1010101010000000001
1010101011111110111
1010001000000000001
1010101111111010111
1000100000101010001
1011111111101110111
1000101010000000101
1011101011111110101
1000000000000010001
1010111111111010101
1010101000001000101
1111101111101110111
1000100000100000001
1110111011111110111
1000000000000000001
1110101010101111101
1000101010100010001
1111111111111111111
