1111111111111111111
1000001000000000101
1011111111101110101
1000100010000010001
1011111011101110111
1000100000001000001
1110101110111111111
1000101000000000001
1011101110101110101
1000101000100010101
1110111011111011111
1000100000101010001
1010101011101111101
1010101000001010101
1010111011101010101
1010000010100000001
1110111110111111101
1000000000000000101
1111111111111111111
