1111111111111111111
1000001000001010101
1011111010101010101
1000001010101000001
1111101111101111101
1010000010001000101
1010101010101110101
1000101000101000001
1111111111101011111
1010000000101000101
1010101010101010101
1010101010001010101
1010111011101011101
1000001010000000001
1111101111111111111
1000001010001000001
1010101011101010101
1010100000000010101
1111111111111111111
