1111111111111111111
1000000000000000001
1010111111111011101
1010000000001010001
1011111110101110101
1000000010100010101
1010101010101110101
1010101010101000101
1010101110101111101
1010101000100000101
1011111010101110101
1000001010101000101
1010101010101010111
1010101010101010001
1111101010101111101
1000001010101000001
1110101011101110111
1000101010001000001
1111111111111111111
