1111111111111111111
1000001000001000001
1011111110111011101
1010000000000000101
1010111010111011111
1010001010001000101
1010101111111111101
1000100000101000101
1011111111101110101
1000000000001010001
1011111011111010111
1000100010001010101
1010111111101010101
1010000000000000001
1010111111111010101
1010100010100010101
1011101010111011101
1000001000100000101
1111111111111111111
