1111111111111111111
1010101010001000001
1010101010111011111
1000101000001010101
1011101110111010101
1010000000001000001
1010101111101111101
1000100000100000001
1010101010101110101
1010101010100010101
1010111110111110111
1010001010100000101
1011111010111010101
1000001000101010001
1011111110101011101
1000001000101000101
1011101111101110111
1000101000000000001
1111111111111111111
