1111111111111111111
1000000010000000101
1111111010111110101
1000001000100010001
1011101011111011101
1000101000000010001
1110111111101110111
1010000000001000101
1011101111111011101
1000101000000000001
1010101011111111111
1010001000001000101
1011111111101010101
1010100000100010101
1010101011101110101
1000101000001000101
1011101111111111101
1000100000000000001
1111111111111111111
