1111111111111111111
1000000000001000001
1011111011111110111
1010001000000010001
1010111111111110111
1000000010101000001
1010101110101010111
1010100000000010001
1011101111101010111
1010000000101010001
1110101011111010101
1000101010100010101
1011101110111011101
1010000000101000101
1111101111101011111
1010000000001010101
1011101111101110101
1000000010000000001
1111111111111111111
