1111111111111111111
1010101000000000001
1010101010101111111
1000000010101000001
1011111110111011101
1000001000000000101
1011111011111010101
1010001010001010101
1110111010101011111
1000001010100000001
1111101111111011111
1010001010001000101
1010111010111011101
1000000000101000001
1011111011101011111
1010101000000000001
1010101110111010101
1000000010001010101
1111111111111111111
