1111111111111111111
1000000010000000001
1111101111101010111
1000001000101010001
1010101110111011111
1010100010000000001
1011111010101010111
1000101010101010001
1110101110111111111
1000100010001000101
1011101110111110101
1000000010000010001
1110111010111010101
1000100000101000101
1110101010101010111
1000101010100010101
1110111110111010101
1000001000001010001
1111111111111111111
