1111111111111111111
1000100010000010001
1011101110111110101
1000101000101000101
1011101110101010101
1000000010001010101
1110101110111011111
1010100000100010001
1010101011111011101
1010101000000010001
1010111011101111101
1010100010100000001
1010101010111110101
1000101010100010101
1011101010101011101
1000101000001010001
1010111011111110101
1010100000001000101
1111111111111111111
