1111111111111111111
1000000000000000001
1011101111111011111
1010000010000000001
1011101011101110101
1000101000100010101
1111111011111010111
1000000000001010001
1010111111111011101
1010000010000000101
1011111110101110101
1000001000101000101
1011101110101010101
1000100010101010101
1111111011111010101
1000000000001010101
1011111110111011101
1010000000100000101
1111111111111111111
