1111111111111111111
1000000010000010101
1110111110111110101
1010101000100000001
1010101011111011111
1010000010001010001
1010111110101011101
1010100010101010101
1010111010111010101
1010001010001000101
1010111010111010101
1000100000101010001
1110101111101010101
1000000010101010101
1111101110101111101
1010001010101010001
1011101010101010111
1000000000000000001
1111111111111111111
