1111111111111111111
1000001000001000001
1111101111101110101
1000001010101000101
1010101010101011111
1010100000100010001
1111101110101110101
1000101010001010101
1010101010111011101
1010100010101010001
1110101110101010101
1010001000000000101
1011111011101110111
1000000010100010001
1110111110101011101
1010100000001000101
1010111011101111101
1000100000100000101
1111111111111111111
