1111111111111111111
1010000010000010101
1010101110111010101
1010100010001000101
1011101111101011101
1010000010001000001
1011101111101111111
1010001010100010001
1011101010101111101
1000000000100010001
1011101110101010101
1010000010001000101
1011111111111111101
1010000000101010001
1010101110101010101
1010100010000000101
1011111111111111101
1010000000000000001
1111111111111111111
