1111111111111111111
1010000000000000001
1011111111111111101
1010001010001000101
1011101011101011101
1010000010001000001
1011101110111111101
1010000010001000101
1010111110111011101
1010000000000000001
1011111110111111111
1000101000101010001
1010101110101011101
1010000010100010101
1011101010101010101
1010001000001000001
1010101111101011101
1010101000001010001
1111111111111111111
