1111111111111111111
1000000000000000001
1011101010111011101
1010001010001010001
1010101110101010101
1010101000101010101
1010101111111110101
1010100000100000101
1110101111111011111
1000101000000000001
1110111110111011101
1000001000001010001
1010111010111111101
1010100010100000001
1110101111101110101
1000100000100010101
1111101111111010101
1000001000000010101
1111111111111111111
