1111111111111111111
1010001000101000001
1011101010101010111
1000000010100010101
1110111011111011101
1010001000000000001
1011111011101110111
1000000010000010001
1011101010101010101
1010001010101010101
1111101011111110111
1000001000100000001
1010101010111110111
1010101010100000001
1011111110111010101
1000100000101010101
1011101110101111101
1010001000001000001
1111111111111111111
