111111111111111
100000000000001
101110111111101
101000000000101
111011111010101
100010000010101
101011101011101
101010001000101
101011101111101
101010001000001
101010111110111
101010100000001
101011111011101
101000001000101
111111111111111
