111111111111111
100000001010001
101010111010101
101010001000101
101111111010111
101000000010101
101110111011101
100000001000001
101011101110101
101000100010101
111010111011111
100010001000001
101110111111101
101000001000001
111111111111111
