111111111111111
100010000010101
111010111010101
101000100010001
101110111011101
101010100000001
101010101010101
100010101010101
101110101110111
101010101000101
101011101111101
101010000000101
101010101011101
100000101000001
111111111111111
