111111111111111
100000000000001
101011101111111
101010101010101
101110111010101
101000000000001
101011111111101
100000001000001
111011101110111
100000100010001
101111111111111
100010100000101
111010101110101
100000001000001
111111111111111
