111111111111111
100010000010001
101111111011101
100010000000101
101110101010101
100000101010001
111011111010111
100010000010001
111011111110111
101000001010101
101010101010101
100010100010001
101111101011101
101000001010001
111111111111111
