111111111111111
100000001000001
111011101110101
100010001000101
101110111011101
101000100010001
101011111010111
101000000010001
101111111111101
100010001000101
101010111010101
101010000010101
101011111110101
101000000000101
111111111111111
