111111111111111
101010000000001
101011111011111
100000000010001
111111101110101
101010000000101
101011101111111
101000100000001
101110101111111
101000000000001
101010101110101
100010100010101
111110111111111
100000000000001
111111111111111
