111111111111111
100010100000001
101010101111101
101010100010001
101010111110111
101000101000101
101111101011101
100000001000101
101111111110101
100000000010101
101110101110101
100010100000101
111010111111101
100010000000001
111111111111111
