111111111111111
100000000000001
111011111111111
101000000000101
101011111111101
100010000000101
101011111110101
101000100000101
101010111011101
101010101010101
101010101010101
101010100000101
101010101110101
101010001000001
111111111111111
