111111111111111
101000100000001
101110111011111
100010001000001
101011101111101
101000100000001
111110111111101
100000001000001
101111101011111
101000001000001
101011111111101
101000001000001
101111111011111
100000000000001
111111111111111
