111111111111111
100000000000101
111110111111101
100010000010001
111010111110111
100000000010101
101011101110101
101010000000101
101111101011101
100000101000001
101011111011111
101000100000001
101110101011101
101000101010001
111111111111111
