111111111111111
100000000000001
111011111010101
100010000010101
111010101111101
100010100000101
111010101011111
100010101000001
101111101011101
100010001000101
111010101011101
100010101010001
111011111011111
100010000000001
111111111111111
