111111111111111
101010000000001
101011101111111
100010100000101
111010101011101
100000001010101
101010111110101
101010000010001
111110111111101
101000100010001
101110111010111
100000000000001
101010101110101
101010101000101
111111111111111
