111111111111111
101000100010001
101011101111101
100000000000001
111011101011111
100010001010001
101010101010111
101010101000001
111110101011101
100000101010001
111010111110101
100010100000101
111010101011101
100010101010001
111111111111111
