111111111111111
100000101000001
101111101010111
100010001010001
111010111111101
100010000010001
101011101010111
101010001010001
101010111011101
101000101000101
101111101110101
100000001000101
111011111011101
100000001000001
111111111111111
