111111111111111
100010100000101
101110111110101
100000001000101
101110101110101
101000100010001
111111101110111
100000000000001
111110101011101
101000101010001
101110101011101
100000101010001
101110111011101
101000100010001
111111111111111
