111111111111111
100000001010101
111010101010101
101010100000001
101111101110111
100000000010001
111011101110111
100010101000001
111010111011101
101010100010001
101010101011101
100010001010001
111011101011111
100000101000001
111111111111111
