111111111111111
100000000000001
101010101111101
101010100000101
101010101110101
101010101000101
101110101010101
101000101010101
101011111010101
101000001010101
101010101010101
101010101010101
101010111110101
101010000010101
111111111111111
