111111111111111
101000100010101
101011101110101
100000100000101
101111111010101
100010100010101
101110111011101
100000100010101
111110111010101
101000100000101
101010111011101
100010000000001
111011111111101
100000000000101
111111111111111
