111111111111111
100000100010001
101111111010111
101000001000001
101011111110101
100010000000101
111010111010111
100000100010001
111111101111111
100000001000101
101011101110101
101010100000001
101110101011101
100000101010001
111111111111111
