111111111111111
100000000000101
101111101110101
101010001000101
101010111110101
100010000010101
101111101010101
101000101010001
101010111011101
101010000010001
111010111110111
100010100010101
101111101010101
100000001010001
111111111111111
