111111111111111
100010000010001
101110111111101
100010100010001
111010111010111
100000000000101
111111101111101
100000000000001
111010101111111
100010100000001
101110111010111
101000100010001
111110111011101
100000100000101
111111111111111
