111111111111111
100000100010001
101011111011101
101010000010001
101110111010101
100000100010101
111011101110111
100010001010101
101110101010101
100010100000001
111011111111101
100000100010101
111011101110101
100000000010001
111111111111111
