111111111111111
100000000010001
101111101010101
101000001000101
111011111111101
100010000000101
101110111110101
100010001000101
111010101111101
100010101000101
101110101010101
101010101010001
111010101011111
100000100000001
111111111111111
