111111111111111
100000000000001
111010111110101
100010100000101
111110111011111
100000001000001
101111111111101
100010000000001
101010101011101
101010101010001
101111101011111
100000101000001
101010111110101
101010000010101
111111111111111
