111111111111111
100000000000001
101111101110101
100010000010101
101111111110101
101000000000101
111110111010101
100000001010101
101111101110101
100000101000101
101011101010111
101010001010001
101011111110111
101000100000001
111111111111111
