111111111111111
100000001000101
101111101010101
100010001010101
111111101011101
100010101000001
101110101010111
100010000010101
111010111110101
100010101010001
111010101010101
101000000010101
101011101111111
100000100000001
111111111111111
