111111111111111
100000000000001
101011101010101
101000101010101
101111101011101
100010001000101
111010111111111
100010000000001
101110101011101
100010101000101
101011111011111
101010000000001
101010101110101
101010101000101
111111111111111
