111111111111111
101000000010001
101011101011101
100000101010001
101111101010111
100010001000101
111010111111101
100010000000001
101111111111111
101000100010001
101010101011101
101010001000001
101011111111101
100010000000001
111111111111111
