111111111111111
100000100000001
101111101011101
100000101000101
101111111011111
100010100000001
101110101111101
101000000010101
101011111110111
100000000010001
101110101010111
100010101000001
101010101110101
101010100010101
111111111111111
