111111111111111
100000000000001
111110101010101
100000101010101
101010101110111
101010100010001
101110101111101
101000101000001
111111101010101
100000001010101
111011111011111
100000001000001
101010111111111
101010000000001
111111111111111
