111111111111111
100000000000001
111110101011101
100000101000101
111011101110101
100010001000101
101010111111101
101010000000101
101011111011101
101010000000101
101010111011101
101010100010001
101011101110101
101000101000101
111111111111111
