111111111111111
100000001000001
111110101011111
100000101000001
101110101111101
101000100000101
101111111110101
100000100010101
111110101010101
101000101010001
101011101110111
100000100010001
111110101011101
100000101000001
111111111111111
