111111111111111
100000000000001
111011111011101
100000001000101
101011101110101
101000100010101
101010111111101
101010001000001
101011111110111
101010000000001
101010101010101
101010101010101
111011101110101
100000100010101
111111111111111
