111111111111111
101000000000001
101010111111101
100010100010001
111110101011101
100000101000101
101111101110101
100000101010101
101110101010111
101000100010001
101010111011101
101010100010001
101011101110101
101000001000101
111111111111111
