111111111111111
100010000000001
101111101111101
100000100010001
101011101111101
101000000000101
111011111011101
100000100010001
111011101111101
100000101000001
101111101110111
100000101000001
101011101110101
101000100010101
111111111111111
