111111111111111
100000100000001
101110111011101
100010001010001
101011101010101
101010001010101
101010111110101
101010000000101
111011111111101
100010000000101
101010111110111
101010100010001
101110111011101
100000001000001
111111111111111
