111111111111111
101000001000001
101011101011111
100010101000001
101110101111101
100000100010001
111011111010111
101010000010001
101011111111101
101000100000001
101110111011101
100010100010101
101010101110101
101000001000001
111111111111111
