111111111111111
100000001000001
101110101111101
100010100000001
111010111111101
100010001000001
101111101011111
100010001000001
111110111111101
100000100010001
101111101110111
100010100010001
111010101011101
100010001000001
111111111111111
