111111111111111
101000001000101
101111101011101
100000100000001
101010101010111
101010101010001
111011101011101
101010001010001
101010111111101
100010000010101
101010111110101
101000000010001
101110111011111
100010001000001
111111111111111
