111111111111111
100000000010101
101111101110101
100010101000001
101110111011111
100000100000001
111110101111111
100000101010001
101111101011101
100010100000001
101110101110111
100000001000001
101110111010111
101000100010001
111111111111111
