111111111111111
101000000000001
101111111011111
101010001000001
101011101010111
101000000010001
101010111010111
101010001010001
101110111111111
101000001000001
101010101110111
100010101000001
101011111010101
101000000010101
111111111111111
