111111111111111
100010100010101
111010101110101
101000101000001
101011101011111
100000101000001
111110101110111
100010001000001
101110101011101
100010100010001
101111111011111
100000101010001
101010101010111
101010000000001
111111111111111
