111111111111111
100000100010001
111010101010101
100010101010101
101111101111101
100000000000101
111111111110101
100000100010001
101110101010111
101010001000101
101010111110101
101010100010101
101010101011101
100010001000001
111111111111111
