11111111111111111111111111111111111
10000000000000000000000000000000001
10111011111111101010111110111111101
10100010000000001010100000000000101
10111111101010101110111010111111101
10000010001010101000001010000010001
11101111101111101110101110101010101
10000000101000000010100010101010101
10101010101010101010111011111111101
10101010101010101010001000001000001
11101110101011111111101110101010111
10000010101000100000000010101010001
10111010111011101011101110111111101
10100010001000101000100010000010001
10101010101110101010101111111110101
10101010101000101010101000000000101
10101010111111111110111010111011101
10101010000000001000001010001010001
10111010111110101110101111111110101
10001010000010100010100000000010101
10101010111010111110111111101010111
10101010100010000010100000001010001
11101010101011101111101111101111101
10001010101010000000100010000000101
10111010101110101111111011101010101
10001010101000100000100000101010101
11111111111011111011111111101110101
10000000000000100010000000000010101
10111010101110111011101011101110101
10001010101000001010001000100010101
10101010111110101110101010101110101
10101010000010100010101010100010101
11101010111110101010101111101111111
10001010100000101010101000000000001
11111111111111111111111111111111111
