11111111111111111111111111111111111
10001000000010001000000000000010101
10111111101110111110111010111110101
10100010000010001000001010001010001
10111010101010101110111011111010111
10100010101000100000001010001010001
10111011111111101111111010111010111
10101010000000000010001000100000001
10101010111011111010111011111110111
10000000100010001000100000101000001
11101010111010111110101111101110111
10001010001010001000100000100000001
11111011101111101110101010101010101
10000010101000001010101010101010101
11111110101110101011101011101111101
10100000000000101010001000100000101
10101011111010111010111011111111101
10001010000010101000001010000000101
11101110111011101110101010111010101
10000010001010001000101010101010001
10101111111010111111111011101111101
10101010100000100010000000101000101
11101010111011101110111011101011101
10001010000010000010001000000000001
10111010101110101111111110111110101
10101000100000100000100000100010101
10101011111010101111111010101111111
10100000001010101010000010100000101
11101110101011101011111110101110101
10100010101010100010000010001010001
10111110111010111011111010101011101
10000010001010101000100010101000001
11101010111110101110111011101110111
10001000000000000010000010001000001
11111111111111111111111111111111111
