11111111111111111111111111111111111
10100010000010000000001000100000001
10101110111110111111101011101110111
10000010000000101000001000000010001
11111010111110101011101111111110101
10000010100000100010001000000010101
10111011101111111010111011101011101
10100010001000000010001010001000101
10101110101011111111101011111110101
10100000101000101000001000100010101
10111111101110101011111011111010101
10001010001010100010001000100010101
10101010111010101110101110101110101
10101010001000101000101000100010001
10101011101111101011101011111011101
10101010001000101000101000100000101
10101010111010101110101011101110111
10100010001010001000101000001010001
10111111101011111011111111111011101
10001000101000001000000010001000001
11101110101111101111111010101011101
10001000100000100010100010100010001
10111011111111111010101110101110111
10001000000000000010100000101010001
11111011111111101110111111101011101
10000000000000100000101000101000001
10111111111110111110101010101111111
10100000100000100010001010101000001
10111110101011101111111010101011111
10001000101000101000000010001000001
10101011101110101011111011111011101
10101010001010100000100010001000101
10101010101010111110101010101111101
10100010100010000000101000100000001
11111111111111111111111111111111111
