11111111111111111111111111111111111
10000000000000000000000000000000001
11111011111010101011101010111010111
10000000100010101000101010001010001
10101110111110101110111110111010101
10101000100000100010100000100010101
10101110111011101111111111111011101
10101000001010000010000000000010001
11101011101110111110111110111011101
10001010001000100000000010100010001
10101011101011101011111011111110101
10101010001010001010000000001000101
10111011101011101011111011101011101
10001010001010001010000010001000101
10101010101010101111111111101110111
10101010101010100010000000000010001
10101110101011101110101110111010101
10100010101000101000101000001010101
10101011101010101011111111101011101
10101000101010101000100000001010001
11101111101011101010101110111111111
10000000101000101010100010000000001
11111010101110101111111111111110111
10000010100010101000000000000000001
10111111111111111111111010111110101
10100000000000000000000010000010101
10101011101010111011111111111110101
10101010001010001000001000000000101
10111011111010111010101110101111101
10001000001010001010101000100000101
11101110101011111011111111101110111
10001000101000100000001000001000001
11111010101010101110111111101110101
10000010101010100010000000101000101
11111111111111111111111111111111111
