11111111111111111111111111111111111
10000000100000000000100010101000101
10111111111111101110111010101110101
10101010000000000010100000000010001
10101011111111101110111111101110101
10101010000000000010101000100010101
10101011101111111011101110101110111
10000010100010001000001000100010101
11111010111110111010101110111010101
10100000001010001010100000000000101
10111010101010111011111111111011101
10001010101000100010101010000010001
10111110111110111110101011101110111
10000000101000100000100000000000001
11111110101110111011111111101111111
10000000001000000010100000101010001
11111011101111111010111110101011101
10000000101010001010001010000010001
11101011111011101011101010101111101
10101000100010100000100010100010101
10111110101010111011111010111110101
10001000101000001000100000100010001
10111110111110111010111110101110111
10100000101010000010000010000010001
10111110101011111110111011101110111
10000010000000100000100000000000001
11101110101110111010111011111011101
10000000101000100010101000001000101
11111111111110111111101010111011111
10001010000000101000101010001000001
11101011111110101011101011101111111
10000010101000101010101010100010001
11101010101010101010101010111110101
10001000000010000000000000000000101
11111111111111111111111111111111111
