11111111111111111111111111111111111
10000000000010000010000010001000001
10111011111011101011101010101110101
10001010001000001010001000101000101
10101110101111111010111111101011101
10100000100000001010101000001010101
10111111111111101010101011111010101
10100000000000101000101000001010001
10101111111010101111101111101010111
10101000000010100010000000000010001
10111011111110111010111110111111111
10001010000010001010100010100000001
11101011101111101011101011101111101
10001010001000001000001000100000101
10111010111011111111111010111110101
10100010000010001000001010100010101
10101011111010111011101110101010101
10001010001000100010100010101000101
11111110101111101110111010101111101
10000000101000001000001010000010001
10111111101011111010101011111110101
10000000100010001010101000100000101
11111110111010111110111110101111111
10000000100010000010000000100000001
10111110111111111010111111101111101
10100000100000000010100000001000001
10111110101111111110111111111011111
10000010100010000000100000001000001
10111011111010111111101111101111101
10001010000010001000001000100010001
11101010111111101011111011111010101
10001010000010100010001000100010101
10111011111010111110111010101110101
10001000000010000000000010000000101
11111111111111111111111111111111111
