11111111111111111111111111111111111
10000000101000100010100010101010001
11101111101011101110111010101010101
10000010100010100010000000101000101
10111010101010101110111011101110111
10100000101000100000101000000000001
11111110101111101010101010101011111
10100000000000001010100010101000001
10101011111110111111111111111111111
10001000101010101000100010001000101
10101011101010101010101010111011101
10101000100000001010001010000000101
11111011101111111111101011111011101
10001000100000001000001010000000101
10101010101010101011111110101010101
10100010101010101000000010101010001
11101111101110101010101111111111101
10000000101000100010100010000000001
10111111101111111111111111111111101
10100010100000001000100010100010001
10101110101111111110101110101010111
10100010100000001000000000001010001
10101110111110111111111010101011101
10100000100000001000000010101000001
10111110101111111011111111111011111
10000000100010000000100010001010001
10111111101110111110101110101010101
10000000100000001000000010100010101
11111011101111101011111010111110111
10000000100010001000100010000010101
10111011111111111110111110101010101
10001000101000100010100010101010001
11101110101110101010101011111011101
10001000100000001000001010000000001
11111111111111111111111111111111111
