11111111111111111111111111111111111
10000000100000001010000010101000001
10111110111011111011101110101011101
10100000001000101000000000100010101
11111110111110101011111011101110111
10001010001000100000001010101000001
11101010111110101010101110101011111
10000000000000001010100000101000101
10101010111010101110111011101110101
10101010101010101000001010000000001
11111110101111111111111110111011101
10000000000010000010101000001000101
11111010101111101110101011111111111
10001010101010000010001000001000001
11101110111010111110111010111110101
10000000100010000010001010000010101
11111110111010111110111010111110111
10001010001010001000000010101010001
11101010111010111010111111101010101
10100010001000000010000000101000101
10101110111011111010101110101011111
10000010100000001010100010000000101
11111010111010111111111110111011101
10000000001010101000001000100000001
10101110111110101010111110111011101
10101000100000000010000010100000101
11101110111011101110101111101010111
10101000000000100010101000101010001
10101111101010111011111010111110101
10000010001010101000001010100010101
11101111101011101011101011101011101
10101000001000100000100000101010001
10101110101011101110111011101110101
10001000101000100010100000000010101
11111111111111111111111111111111111
