11111111111111111111111111111111111
10100010000010000000000010001000101
10101010111011111111111010101010101
10001000001010000000100000100010101
10101111101010111110101111111110101
10100010001010001010101000000000001
10111110111011101010101011111111111
10100010101000001000101010001000101
10101010101111101111101110101110101
10101000100000100010000000100000101
10101111101110111010111111111111101
10101000001000001010100010000000101
11101010111111111010111010111110101
10001010100000100010001010001000101
10111010101110101110101010101110101
10100010100010001000100010100010001
10101111111011111011101111111011111
10101000000010001010001000001000001
10101011111110101010111010111111101
10001010000010100010100010000000101
11111010111010111110111011111010101
10001000100010001010001000101010101
10101111111011101011101010101011101
10100000001000101010001010101000101
10111111101110101010111110101110101
10001000000010001000001000100010101
11101011111111111111101011101010101
10101010000000100010001000001010101
10101010111010111010111011111110101
10001000101010100010001000100000101
11111111101010101110111110101011101
10000000100010100010000000101000001
10111110101110101111111111111111101
10000010000010000000000000000000001
11111111111111111111111111111111111
