11111111111111111111111111111111111
10000000000000000000000000000000001
10101111101111111010101010111010101
10100010000000100010101010001010101
10101011111010111011111011101010101
10101000100010100010000000101010101
10101010111010101010101010111111101
10101010100010101010101010000000101
10111110111111101111101111111011101
10000010000010000010000000100010001
10101111111111101111111010101111111
10101000000000001000000010100000001
10101011101110101111101110101010101
10101010000010100010000010101010101
10111111111111101110101010111111101
10000000000000101000101010000000101
11101111101010101111111011101111111
10000000101010100000001010000000001
10101011101011111110111010101110101
10101000101010000000100010100010101
10101010101010111110111110111010101
10101010101010001000100000001010101
10111010101011101110111011101010101
10100010101010001000100000101010101
10101111111110101011101110111110101
10100010000000101010001000000010101
10101111111110111110101011111011101
10100010000000000010101000001010001
10111011111110101111101010101010101
10100010000000101000001010101010101
10101110101111101111101111111110101
10100010101000000010001000000000101
10101111101010111010111010111010101
10100010001010001010100010001010101
11111111111111111111111111111111111
