11111111111111111111111111111111111
10101000001000100000001010100000001
10101110111011111110111010111011111
10101010000010000010100000100000101
10101010111010111110101111101111101
10100010101010100000000000001000001
10111010101110111110111010101011111
10000000101000001000101010101000101
11101110101011111110101011111011101
10000010001000101010001010000010001
11101111111011101010111110111010111
10001000000000001010001000100000001
10111110111110111010111011111111101
10001000000010101000100010100010101
10111011111111101110111010101110111
10000000001010101000100000100000001
10111011111010101011101110101111101
10001000100010001000000010100000101
10111111111010101010111010101111111
10000010100010101010101010101000001
10111110101110111011101011101110111
10000000000000000000001000000000001
10101111101111101011111011111011101
10100010101010001000001010001000101
10111110111011101110111010111111101
10000000000000101000001000001000101
10111011111011101010111111101110111
10100000001000101010000010100000001
11101010111011101111101010111011111
10001010100000100000101000001000001
11101011101010111011111111111011111
10001000101010101000101010100000001
11101010111011101111101010111011111
10001010100000000000000000001000001
11111111111111111111111111111111111
