11111111111111111111111111111111111
10000000000000000000000000000000001
10111110101011111010111011111010101
10100000101010000010100000001010101
11101010111111111111101011101011111
10001010001000000000001010001000001
10101111111110111010111111111110111
10100000000010001010100000000000001
10101010111011101011111010111011101
10101010001010001000001010100000101
10101110111110101110111010111011101
10100010000010100010001010100010001
10101011111011101111101010111110101
10101010000000101000001010000010101
10101010111010101010111010111010111
10101010100010101010001010100010001
11101011111011101010101011111011101
10001010000000101010101010000010001
10101110111111111010101011101110101
10100010100000000010101010000010101
11101111111110111111111011111110111
10001000000000000000001000000010001
11101111111111111010101011101110111
10000000000000001010101010001000001
11101011101011101110101010101111101
10001010001010000010101010100000101
10111110111110101110111110101010101
10000010001000100010001000101010101
11111010111110101111101110101110101
10000010001000101000000010100010101
10111110111110111010101010101110101
10000010100000001010101010100010101
11111110101110111011111110111010101
10000000101000100000000010100010101
11111111111111111111111111111111111
