11111111111111111111111111111111111
10100000100000000000001010000000001
10101110101111101111101010101111101
10101010101000101000000010100010101
10101010101110101111111010111010101
10001010100010100000100010001010101
10111010111010111110111011101010101
10000010001010001010001010001010001
11101111101010101011101110111011101
10101000100000100000100010001000101
10101010111111111011111010111110101
10001010000010000010000010100000101
10111011111011111110111110101111101
10001010001000100000100000101010001
11101010101110101110101111101010111
10101010100010101000100010001010001
10101011101010101011111010111011101
10101000101010101000100010100000101
10101110101010101111101110101011101
10100010101010101000001000101010001
10111011101110101011111011101010111
10100010000010101000101010001010001
10101110111010101110101010111111101
10001000001010100000001010000000101
10111111111010101111111010111110101
10001000100010100010001010101000101
11101010101110111110101010101010101
10101010101000100000100010001010101
10101010101011101111111111111011101
10001010001000100000000010001010001
10111011111110111110111010101010111
10100010000000100010100010100010001
10101010111111101011101110111111101
10001010000000001000001000000000001
11111111111111111111111111111111111
