11111111111111111111111111111111111
10100000000000100000000010000000101
10101111111010101111111011101110101
10001000001010000000001000100010001
10111111101111111111111010111011111
10001000100000100000001010100010001
11101011111110101111101010101010101
10001000000010101000101010101010101
10111011101110101010101110101110101
10001000100010001010101000100000101
11101111111011111110101011101111101
10100000001000001000100010001000001
10111111101110101010111111111011101
10000010001000100010000000001010101
10101110111011111111111111101010101
10100000100010000010000010001010001
10111111101110111010111010111010111
10100000101010001000101010001010101
10101110101011101111101011101010101
10100010101000100010001000100010001
10111010101010111010101011111111101
10001010001010100010101000100000101
11101010111110101111101110101011101
10101010100010000000000010101010001
10101011101011111111111010101010111
10101000001000000000001010101000101
10101011111111111111101110101111101
10001000000000001000001000100000001
10111111111111111011111011111111101
10100010001000001000100010000010001
10101010101011101010101110111010111
10001000101010101010100010101010101
11111111101010101110101010101010101
10000000000010000000101000001000001
11111111111111111111111111111111111
