11111111111111111111111111111111111
10101010001000000010101010100000001
10101010111011111110101010101111111
10000000001010000010000000101010101
11101011101011101110111111101010101
10101010100010000010000010000000001
10111010111011111010111010111111101
10000010100010000000001000000000101
11111110101010101110111110111111101
10100000101000101000000010000010001
10111110111110101110101110111111101
10001000000000100010101000000010001
10111011101111111011111111111111101
10000010001000000010001000001000101
10101111101111111010111011111011111
10101000100010001000001010000000001
11111110101110111010111011101110101
10000000001000100010000000100010101
11101011101110111011101011101010101
10101000100000001010001000001010101
10111011101110111111101010111110111
10100010001000001000001010100010101
10101011101110101110101011101111101
10001000100010101000101000000010101
10101010101110111010111010101010101
10101010101000100010001010101000001
11101011101110111010101010101011101
10001000101010101010101010101000101
10111111111010101011111010111011101
10001000001000001000100010001000101
11111110101010111011101110101111111
10100000100010100000100010100000001
10101111111011111011111110101110111
10001000000000100000100000101000001
11111111111111111111111111111111111
