11111111111111111111111111111111111
10000000000010001000001000000010001
11111110111110101011101111101010111
10000010000000100010100000101000001
10101011111111111010111010111111101
10101000001000000010001010001000001
10111111111011111111101011101011111
10100000000010100010001000100000001
10101111111010101010101111111111101
10001000000010001010100000000010101
11111011111110111010111111111010101
10001010000000100000100000000010101
10101010111111101111111111111110101
10100010100010000000000000100000101
10111010111011111111111110101111111
10100010000000000000100010100000001
10111011111111111110111010111111101
10100000001000100000100010001000101
10101111101010101111101111101010101
10101000101010001000000000101010101
10101110101011111011111110101010101
10101000101000100010001000101010001
10101011101110101111101011101011111
10100010001000100000100010101010001
10111110111111101110111010101010111
10000010001000101010001000001010001
11111011101010101011101111111011101
10001010001010101000100000001000001
10101010111010101010111111111011101
10100010001010100010000010000010001
10111110111010101011111010111111111
10100010000010101010001010000000001
10101011101110101011101011111111101
10001000100010001000001000000000001
11111111111111111111111111111111111
