11111111111111111111111111111111111
10100000100010001000000000100000001
10101010101011101011111110101111101
10001010001000100000100010001000101
11111011111110111111101011101010101
10000010000010001000101000101010001
10111110111111101010101110111011101
10100010000000100010001010001000101
10101110111110101111111011101110101
10100000100000101000100010000000101
10111111101111101010111010111111111
10000000100000101010001000100000001
11111110111110101011101111101111101
10000000100010001000100000100000101
10111110101011111110111110101111101
10100010101000000000100010001000101
10101011101111111111101011111010101
10001000001000100000001010001010101
10111111111011101111111010101010101
10100000100000100010001000100010101
10111011101110111010101111111110101
10001010001010001000101000000010001
11101010111010101111101011111011101
10001000000010101000001000100010001
10111111111110111011111110101110111
10100010000000100010000010100000101
10101010111111101010111010111111101
10101000100000001010100010100000001
10101111101111111010101110111110101
10101000001000000010101000000010101
10101010111111111010101111111010101
10001010100010001010100010001010101
11101011101010101111111010101011101
10001000001000100000000010100000001
11111111111111111111111111111111111
