11111111111111111111111111111111111
10001000100000000000000010000000101
11101010101111111111101010101110101
10001010001000000000001010100010101
10111011111011111011111110111010101
10001010001000001010000000100010001
11101011101111101110111111101111101
10001000100000100000001000001000101
10111110101110111111101011111011101
10001000101000100000101000100010001
10101011111011101110111110101110111
10101010000010001010000010101000101
10101010111110111011111010101011101
10100010001000100010000010101010001
10111111101011111010111110101011101
10100000001000001010101000100000001
10111011101111101010101010111111101
10100010000000101000100010000010001
10101111111110101011111111101011111
10100000000010101000000000101000001
10111111111011101111111110101111101
10100000001000100000001000100010001
10101111101110111111101011111110101
10001000100000000010001010000000101
11111010111111111010111010111111101
10000010100000100010100000101000101
11101110101111101110101111101011101
10001000101000001010101000001000001
10111011101011111010101011111011111
10101000001010000010101000101000001
10101111101011101110111110101111101
10100000001000100010100000100000101
10111111111110111010101111101011101
10000000000000000010001000001000001
11111111111111111111111111111111111
