11111111111111111111111111111111111
10000000100000100010001000001000001
11111011101111101110111011101010101
10100010001000101010000010001010101
10111010101010101010101110111111101
10100000100010100000101000001000101
10101010111110101111101011111011101
10101010100000100010001000001000001
10111011111011101110111011101111101
10000000100000100010001000100000001
11111011101011111111111011111111111
10000000101000000000000010000010001
11101111111111111111111011101111101
10001010000010100000000000000010001
11101010111010111010101010101011101
10001010101000100010101010101000001
10111010101110111010101111111011111
10000000001000100010100010001000001
11111011111111111110111110111010111
10000000000000100000000010001010101
11111111111011111010101010111010101
10000010000000100010101010000010001
10111010111111111010111111101111111
10100010000000100010000010000000101
10111111101110101111111010111010101
10000000001000100010000010001010001
11111011101110111011111110111110111
10000010001000100000000010001000001
10111111111110111111111111101111111
10100010100000100000000000000000001
10101010101010111111101111111111111
10001010001010100010001010001010101
11111111111011101110101010101010101
10000000000000100000100000100000001
11111111111111111111111111111111111
