11111111111111111111111111111111111
10101000000010100010101000101010101
10101111101110101010101011101010101
10000000101010001010001000100000001
11101111101010111111101011101110101
10100000100000101010000000101010101
10101111101011101011101111101011111
10000010101000101010000000101010001
11111010111011101011111011101011101
10000010001000100010000010101000101
11111010111011101111101110101110101
10100010100000101010001000000000001
10111010101011101011101111101011101
10101000001010100010000010001010001
10101111101110101111101111101111111
10001000000010000000100010101000101
11101010101111101111101010101110101
10101010100010001000001010000000001
10101111101110111111101110101011101
10100010100010001010100000101010001
10101110111010111010101110111111111
10001000100000101010101010000010101
11101110111110101010101011101010101
10001000100010001010000010001010101
11101110101010111010111111111110101
10101000101010000000000010100000001
10101110101110111011101110101010101
10100010100000001000100000001010101
10101110101010111110101010101110111
10000000001010000010101010101000001
10111011101110111111111010111111101
10100010001010000000001010000000101
10111011101011111011101010101011101
10100010000000100000101010101000101
11111111111111111111111111111111111
