11111111111111111111111111111111111
10000000000000100010000000000000101
10111111111010101010101111111110101
10100010001010001000101010000010001
10101010101111111111101010101111101
10101010100000001000001000100000101
10101010111111101011111011111110101
10001010001010001000001010100010101
11111011101010111011101010101010101
10001010101000100010001010001010001
10101010101011111110111011111011111
10101000101000000000101000000000001
11101110101111111111101111101111101
10001000100010000000001000101000101
10111011111010111110111010101010101
10000010000010100000100010001010101
10111110111110101111101111111010111
10001010000010100000101000001010001
11101011111010111110101011101011101
10001000100010100010001000100010001
10111011101110101011111011111110101
10100000100010101000000010000000101
10111110111011101111111110111111101
10100000101000001000000010001000101
10101110101111111110111111101010101
10001010100010000000100000101010101
11111010101110101110101110101010111
10100010100000101000101010100010001
10101010101111101111101010101111101
10001010100000100000101000100010001
10111010101111111010101011111110101
10001000101000001010101000001000101
11101111111011101110111111101011101
10000000000010000000000000100010001
11111111111111111111111111111111111
