11111111111111111111111111111111111
10101010101000001010000000001000101
10101010101110101011111110101010101
10000010000000101010000010101010001
11101111111011111010111010101011101
10001010001010001010001010101000101
10101010111011101010111110101110101
10100000000000001000000000100000101
11101111101011111111111111101111111
10101010001000101010100000101010101
10101011101010101010101010101010101
10000010001010001000001010000000001
11111111101111111111111011111111111
10001000100010001000100000001010101
11101110111011101010101011111010101
10001000001010101010001000101000001
11101010101010101111101010101111101
10000010100000001000001010001000001
11111111111011111111101110111111101
10001010001000000000001000001010001
11101010101110111111111111101010101
10001000101000001000000000101000101
10101111101110111111111110101011111
10101010101000101000000000101000001
11101010101010101111101110101011111
10001010001010001000100010101010001
10101011101111101011101010101010101
10100000000010001000101010001000101
11111011111011101010101110101110101
10000000101000001010000010100000101
11111010101111101111111111111110111
10000010001000001010000000101010001
10101111101111101010101110101010111
10100010001000001000100010000000001
11111111111111111111111111111111111
