11111111111111111111111111111111111
10001000000000001000000000100000001
10111010111111101011101111101110101
10100010001000101000100000100010101
10101111101010111110111110111010101
10001000101010100010101000001010101
11111010101010101010101011101010101
10000010101010001010101000101010101
10111110101011111010101110111010111
10100010100010001010000010000010001
10101110101110111011111011111111101
10101000101000100010001000100000001
10101011101011101010101011101111101
10100010100010001010100010001000101
11101110111010111110111110111010101
10001000100010000010100000100010101
10111010101111111010101111111110101
10001010100010001000101000000000101
11101110111010111111101110111111101
10100010001000100000100010100000101
10111010111011101110111010101110101
10000010000010001010000010001000101
10111110111110111011111110111011101
10001000000010100000000010100010001
11101111111110101111101011101110111
10100000001000101000001000100010101
10111111101011111011111110111010101
10000000101010000010000010100010001
10111110101011101111101010101111101
10100000101000101000101000001000101
10101111101010101010111111111010101
10100010001010101010100000100010001
10111110111110101010101110101111111
10000000000000100010000010000000001
11111111111111111111111111111111111
