11111111111111111111111111111111111
10001000100000101000100000001010101
11101011111110101010101110101010101
10100000101000100010101000101010001
10101110101011111011111011111011101
10001000100010000000100000100010001
11101111101010101011101110101010111
10000000101000101000001000001010001
10111010101111101011111011111010111
10001010000000101000100000001000001
10101110101011101111101111111111101
10101000101000100000100000000010001
11111111111111101111111111111111111
10000000101000101010100010001000101
10111110101010101010101110111110101
10001000001010000010100010001000101
11101111111011101110101010111110101
10101010000010000000101010101000001
10101011101111111011111010101110111
10001010001000000000100010001010001
11101011101011111111111011101011101
10000000001000100010100010001000001
10111111111010111010111011101111101
10001000101010100010101010001000001
10101011101110101110101011101011111
10100000001000000000100010101000001
10111011101111111011101110101011111
10100000101010001000100010001000001
11111110111010101010101110111110111
10000000001000100010100010001000001
11111111111011111111111010101111101
10000000000000000000100010100000001
11111111111011111111111011101010101
10000000000000000000000000001010101
11111111111111111111111111111111111
