11111111111111111111111111111111111
10000000101000000000100010000000101
11111110101011101111101010111010101
10000000100010000000101010100010001
10101111101110111110101011101111111
10100000001000100010101000101000001
10111111111011111010101110101110101
10100000101000001010101000100000101
10101110101111101010101011111111101
10101000100010100010001010000010001
10101011101010111111111010111010101
10101000001000100000000010001000101
10101111111110101111101111101111111
10101000100000100000100000100010001
10111010101111111011111110111010101
10100010101000001010000000100010101
10101110101110101010111111101110101
10100010001000100010000000101000101
10101011111011111111101110101011101
10101010000000001000100010100010001
10101010111111101110111010111110111
10101010000000101000100010100000001
10101111111110101011111010101111101
10100000001000100000001010100010101
10111011101111111111101010111010101
10001000100010001000001010001000101
11101010111010101111111111101111101
10100010101000100000001000100000001
10111010101111111111101010111110111
10100010101000000010001010000010001
10101010101011111010111011111011111
10101010001000001010001010000010001
10101011111111111010111010111110101
10001000000000000010000010000000101
11111111111111111111111111111111111
