11111111111111111111111111111111111
10000010000000000000000010100000101
10111110111111111011111010101110101
10100010001010001000101010100010001
10101011101010101010101010111111101
10001000000010101010100000100000001
10111111111110101110111111101111111
10100000100010100010100000100010001
10101111101010111010101110111011101
10101000001010100000100010001010001
10101011111010101111111010111010101
10101010001000101000001010001000101
10101010101111111010111011101111101
10001000100010001010000010100010001
11101111111010101011111110111010111
10001000001000100010001010001000101
10111010101111111110101010101111101
10100010101010001000100010100000101
10111010101010101010111110111010101
10001010100010100010000010001010101
11101110111110111111111011101010101
10101000100000100000001000001010101
10101011101111111011101111111010101
10101000001000100010000000100010101
10101011111010101110111111101110101
10101000000010101010001000001010101
10101111111110101010111011111010101
10101000001000001000100010000010001
10101011101111111111101111101011101
10001010100000000000100000101000001
10111010111111111110111110101111111
10100010000000000010100000101000101
10101110111110111110101111101010101
10001000000010000000001000000010001
11111111111111111111111111111111111
