11111111111111111111111111111111111
10100000001010101010001000000010001
10101011111010101010101010111011101
10001000101010000010101010001000101
11101110101010111110111011111111101
10101000000000001000100010001010001
10101111111110111110101010101011101
10001000001000100010001000101000001
10111010111110101111111011101011101
10101010001000101000101010001010001
11101111101010101110101011111110101
10101000100010100010000010100010101
10101110101110101110101010111010111
10000000000010000010101000000010001
11101010111011101011111011111110111
10101010001010001000101000101000001
10101011101011111010101011101011111
10101010001010100010100000000000101
10111111111010111110101010101010101
10000000100000001000001010101010001
10101011101010111111101011111111101
10101010001010001000101000000010001
11101111101111101011111110101110111
10100000000010001000001000101000001
10111110101111101011101011101011101
10000000101000100010101000101010001
11101010101010101010101011101111101
10001010101010001010001000101010101
11111111111111101111111111101010101
10000010000010000010000010000010001
11101110101111101111101010111011101
10100000100000001000101000101000101
10111011101010111010101110101111101
10000010001010100010000010000000101
11111111111111111111111111111111111
