11111111111111111111111111111111111
10000000000000000000000000000000001
10101011111010111111101011101011111
10101000100010001000001000101000001
10101110101111101111111110101011101
10100010100000100000000010101000101
10101111101111111010111011101110111
10101000000000001010001010001000001
10101010101111101110101110101011101
10101010100010000010101000101010001
10101110101010101011101110111111101
10100010101010101010000010000010001
10111110111011101111111110111011101
10000010001000100000001000100000101
10111111101111111010101110111011111
10100000000010000010101000001000001
10111011111011111110111011101110111
10100000001000000010001010001000001
10111010101010101010111111101111101
10001010101010101010001000001000001
10101110111110111011101011101111101
10101000000010001010001000100000101
11111010111011111011101111111110111
10000010100000100000100010000000001
10111010101110111110101010111010101
10100010101000000010101010001010101
11101011101010101111111110111111101
10001010001010100000100000000000101
10111010101010111010101010101010101
10001010101010100010101010101010101
11101010111011111110111110101011101
10001010100000000010000010101010001
10101010111010111011111010101111101
10101010100010001000100010100000101
11111111111111111111111111111111111
