11111111111111111111111111111111111
10000000001000000010100000100000001
10111111111010111010101010101011101
10001000000010001000101010101010001
10101011111111101111101011101010111
10101010000000101000001000001010101
11101010111110101011111111111010101
10001010100000001010000000100010001
10101010111110111010111110101111111
10101010000010100010000010100010001
10101011111011101111111010101010101
10101000001000000000001010101000101
10111110111111111111111010111110101
10100000100000001000001010000010101
10101111101111101011101011111011101
10101000001000100010001000101000001
10101011101010111110111010101111101
10101010001010001000100010100000101
10101011111011101011111010101111101
10001000001010101010001010100000001
10111111101010101010101010111111101
10000000101000101000101010000000101
11111111101011101111101111111110101
10000010101010001000100010000000101
10111010101010111110111010111111101
10001000100010000010000000100000101
11101111111111111011111111101011101
10001000001000001000001000101000001
10111011101011101111101010101111111
10100010101010100000001010001000001
10101110101010111111111011111110101
10001000100010000000001010000010101
11111011111110111011111011101011101
10000000000000001000000000001000001
11111111111111111111111111111111111
