11111111111111111111111111111111111
10001010000000001000101010101000101
11101011111111101011101010101110101
10000000100000000010000010000000001
10111010111110101011111010111111111
10101010100000101000000010100000001
10101011101110111111101110111110111
10101000000010001010100010001000001
11101010111111101010101111101010101
10001010100010001010100000000010101
11101111101110111010101111111111111
10000010000010001000100000000010001
10111110111011101011111111101110111
10000010001000000000100000001000001
10101110111111111011111111101011101
10101000100010001000000000100000101
10101011101110111111101110111111101
10101000101010000000001010101010001
11101110101010111111111010101011111
10100000001000101000101000001010001
10101011101010101011101111111011101
10001000101010100000100000100010001
10111011111110101110111110111011101
10001010001000000010000010100000001
11101111101110111111101110101010101
10001000000000100010000000101010101
11111011101011111010111110111010101
10000000101000100000000010000010101
10111111101110111111101111101011111
10100000100010000000101010001000001
11111110101010111111101011101110111
10100000001010000010100010101000001
10101110111110111010101110101010111
10000010100000001000101000001010001
11111111111111111111111111111111111
