11111111111111111111111111111111111
10000000001000101000100000001000001
10101111111010101110101111101011101
10101000001010001010101000001000101
10101111101111101010101010101011111
10101000000010101000001010101000001
10101110101010101110101011111011101
10100000101000000000101000001010001
11111111111111111011111111111111101
10100000100000101000000000001000001
10101110101010101111111111101011111
10101010001010001000000000001000101
10101010101111101111111011111010101
10001000100000101010000010001010101
10111111111111111010101110101110101
10101010000010001000100000101000001
10101011111011101011111111101011111
10000000000000000010101000001000101
10101110111011101010101110101011101
10100010001010001010000000101000001
11101111101110111010101010101111101
10000010000010001010101010100000001
10101110101010111010111111101110111
10100010101010001010100000001010001
11111011111111111111101111111010101
10000000100000101000100010001010101
11101010101110101011101110101011101
10001010101000001000000000101000001
10111110101110101011111010111111101
10001000101000101000100010101010101
11101111111011111011101110101010101
10000000001010101000100010001000001
10111111101010101110111110111110111
10000000100000001000100000001000001
11111111111111111111111111111111111
