11111111111111111111111111111111111
10000000100000100000100000100000001
10111010101110101110101110101011101
10100010001010001000100010001010001
11101111111011111011101111111010111
10001000100000001010101000001010001
10101010111111101010101011101011101
10101010000010001010001010100010101
10111011111010101011111010111110101
10001010001010101000000010000000101
11101010101010111111111110111111101
10100010101010000000100000001000001
10111111101011101111101111101011111
10000000001000101000101000100010001
10111111101110101010101110111111101
10100010101000100010001000000010001
10101010101011111111101011111010101
10101010101010000000100010000010101
10101010101010111110111110111110111
10101010001010100010100010100000001
10101010111010101010101110101111101
10101010001000101010100010100010101
10101011101111101010101010111010101
10101000101000001010101000100000101
10101110101010111110101111111110101
10101010101010100010100010000010101
10101010111010101010111010111011101
10100010100010101010001010001000001
10111010101110111011101010101111101
10001010001000001010001010100010101
10101011111011111010111011111010101
10101000101000001000101010000010101
10101110101111101111101010111110101
10100000000000100000000000100000001
11111111111111111111111111111111111
