11111111111111111111111111111111111
10001010100010001000001000000010101
11101010101111101110111111101110101
10000000101010100010101010001000001
10101110101010101010101011101111101
10101000101000101010001010000010001
11111110101110111010111011101111101
10001000000000001010101000001000001
11101110111111101010101011101111101
10000010100010000000000000101000001
11111011111011101011101011111011101
10100000100000001000101000001010101
10111010111111111011111011101110101
10001010001000001010001000101010001
10111011111110101111101011111010101
10000010001010100000001000001010101
11111010111011101010101011111011101
10000000000000101010100000100000101
11101110111010111011111110111011101
10001000100010001010100000101000101
11111110111011111110111110101011101
10000010100010001000000000001000101
11101111111011101111111110111110101
10001000000010001010101000101000101
11101111111010111010101010101110101
10001000100000000000001010001000101
11101011111011101111101011101011101
10000000100010101010001010001010001
11101010101110111010101111101010111
10101010101000001000101000000000001
10101011111111101111101110111011101
10001000101000000000000000100010101
11111011101011101010101011101110111
10000000000010001010101010000000001
11111111111111111111111111111111111
