11111111111111111111111111111111111
10000000000000000000000000000000001
11111111111111111111111011111111111
10001010001010101010100010001010001
10101011101010101010101011101010101
10100010000000100000001010001000101
11101110111011111110111110101111101
10000000001000100000000010100000001
11111011101111101110111010111111101
10000010101000100010001000001000001
11101110101010101110101011111011111
10100010000010100010101010000000001
10101111111110111111101011101011101
10000010100010000000001010001000101
10111110111010111111111011111111111
10001010100000100010000010101000001
10101010111011111011101010101110111
10100010000000100010001000001000101
11111011111011101111101110111110101
10000010001000100010001000101010101
11111010101011101010111011101010101
10000010101000101000101000101000001
11111010111011101110101010101110111
10000010000000100010001010000000001
10111010111111111111111111111111111
10001010001010000010100000000000001
10111110111010101010101011101010101
10001010001000101000101010001010101
11101010111110111110101011101111101
10000010001000101000101010001010001
11101111101110101010111111101010101
10000010001000100010001000101000101
10111011101110111111101010101011101
10001010000000000000100010001000101
11111111111111111111111111111111111
