11111111111111111111111111111111111
10000000101010001000101000000000001
10101110101010101010101011101010101
10100010000000100010000010001010101
11111111111111111111101111111111111
10101000000000000010001000100000001
10101010111011111110101010101011101
10100010100000000010101010001010001
10111011111010101010111111101111111
10100000100010101010001000001010001
10101110111011111111101110111011101
10101000100010001010001010001010101
10111011111010111011101011101010101
10101000101010001000001000000010001
10101010101010111010101110111111101
10100010100000000010101000000000001
10101110111110111111111110111111111
10101000101000001000001000001000001
10111110101010101110101110101110111
10100010100010100000101000100000101
10101010101111101110101111101110101
10101000100000101000101010101000001
10101111111111111111111010101110101
10001000101000001000001000001000101
10101010101111101110111110111111111
10101010000000001000100000000000101
10101010101011101010101010101110101
10101010101000101010001010101000001
10101111101111111110111011111111111
10101000000010001000001000100000101
10101110101010111110111011111110101
10101000101000000000001000100010001
10101110101110111011101110101010101
10100000101000001000101000001000101
11111111111111111111111111111111111
