11111111111111111111111111111111111
10000000101000000000001000000000001
11101011101011111111111110111011101
10101010101010101000000010100010101
10111010101010101011111110111110111
10001000000000000000000000100010001
11101011111010101011101111101010111
10101000100010101000100000001000001
10101011111110111111101010111111111
10000000100010000010001010000000001
11101111111011111111111111101111111
10000000000000000000000000100000001
11101111111111111011111011111111111
10000010100010101000001010001000101
11101110101110101011101110111011101
10100000000000001010000000100000001
10101010111011101111101110111110111
10001010001000100000100010000000001
10111110111011111110111111111010101
10100000100000101000000000100010101
10111010111010101111111010111111111
10100010101010000000001010000000001
11111110101010111110111010101010101
10001000101010000010001010101010101
10111010101011101111101011101010111
10000010001010100010101010101010001
10111011101110101110111010101110111
10100010000000100000101000101000001
10111110111110111010101111111010101
10001000000010100010100000101010101
10101011101110101110111011101110101
10101010101000100010101000000010101
10111010101011101110101011111011111
10001000101010000010000000100000001
11111111111111111111111111111111111
