11111111111111111111111111111111111
10000000000000000000000000000000001
10101011101011101110101110101010101
10101010001000101000100010101010101
10101111111110111110111110111111101
10100000100000000010000010001000001
10111010101011111111101011111110111
10100010101000000000101010000000001
10111110111110111010101010101010101
10100000000010001010101010101010101
10111010111110111110111110111111111
10100010001000001000000010000000001
10111011111110111110101010101111101
10100000100000100000101010101000001
10101110101110101011101111101010111
10101000100010101000100010001010001
10101111101010111111111110111011111
10101000001010100000000000100000001
10101010111010111111111011101010101
10101010100010100000000010001010101
11101110111111101011101010101110101
10001000001000001010001010100010101
10111110101111111011111111111011101
10000010101000000010000000000000101
10111011111011111011101110101010101
10100010000000100010000010101010101
10111110111111111010111011101110101
10100000000010000010100010001000101
10101110111011101111111111101111101
10100010001000101000000000000000101
10111111101011111011101111101111111
10000000101010000000101000000000001
10111010111010111010111111111010111
10001010100010100010100000000010001
11111111111111111111111111111111111
