11111111111111111111111111111111111
10000000000000100010001010000000101
11101011101111111010111011101110101
10101000100000000010000010100010001
10111011101111111111101110111110101
10100010000000001010100010000000101
10101111111010111010101111101111101
10101010001010000000101000000010001
10101011101011101111101011111011101
10000010101010001000000000001010001
11101110101111111110111011111111101
10100000001000001000100000100010001
10101110101110111110111111101111101
10000010100000100000001000000000001
11101011111111101011111111111110111
10001010000010001000101000001010001
10101110111011101111101110101010111
10100010101000100010000000100010101
11101010101011111011101010111011101
10101000101000000010001010001010101
10101110101110111011111011111110101
10000010001000100010100000000010001
10101010101111101110101111111010111
10101010100010000010100000001000001
10111111111110101110111011111010111
10001000100000100000001000001010001
10101110111110111111111011111111101
10101000100010001000001010001000101
11101110111011101110101011101010111
10000000001010000000100000000010001
11101110111010111110101111101110111
10000010100000000010100010101000001
10101011111010101111101110111111101
10101000001010100010000000100000001
11111111111111111111111111111111111
