11111111111111111111111111111111111
10000000100000000000101000101000001
11101010101011101111101110101110101
10001010001010000000000000000000101
11101110101011111111111011111110111
10101000101010101000001000001010001
10111111101110101110111011111011111
10000000101010101000000000000000001
10101011111010101110111011111110111
10101000001000000000100010000010001
11101110111111101111111010111011111
10000010000000000000100000001000001
11101111111111101111101111101111101
10000000000010101010001000001000001
10101110101110111011111010111111111
10101010100000100000000010000010001
10111011111110111011111111111010101
10100000001000100000000010001000101
10111110101110111110111110101111101
10000000101010001000001000101000101
11111010111010111110111111101011111
10100010001000001000100010000000101
10101111111111101111111010101111101
10000010101010001000100000101000001
11101010101011101011111011101110111
10001000100000001010000000101010001
11101110111010111010111010111011101
10101000101010100000101010000010001
10101110101111111011101011101011101
10000010100000000010001010001000001
11101110101011111010111011101110101
10000010001000101000001010001010101
10111010101111101011111010111010101
10001010100000001010000010000010101
11111111111111111111111111111111111
