11111111111111111111111111111111111
10100010000010000010100010000010101
10111010111111101110111011101110101
10000000000000000000100000100010001
11111011111111101111111011101110111
10000010000000000010101000100000101
10101110101111101110101011111110101
10101000101000100000000010101010101
10111111111110101110111010101010101
10100010000000001000001000000000001
11111011111110101110111011111010111
10100010100010101010100000001010001
10101110111011111011101111111111101
10000000100000000000101000000000101
10101011111110111111111111111110101
10101000000000001000100010101000001
11111110111110111110101110101110101
10000000101010100010000000000000101
11111110101010101110101011101010111
10100010101000000000101010001010101
10111011101011101110111111101011101
10000000000010001000100000001000001
10111011111011101111111110101110101
10100010000000100010101000101000101
11101111111011101110101110111010101
10101000000010001000000000100010101
10111010101111101010111010111110111
10000010101000001010001010001000001
10101011101010111110111111101110111
10101010001010100000000010101000001
11111111111010101010111110111010111
10000010100010101010101000000010001
10101010111110101011101011101011101
10101000000000101010000010001000101
11111111111111111111111111111111111
