11111111111111111111111111111111111
10100000100010000000100000101000001
10101110101110111110111110101011101
10000010000010100010100010001010001
11111011111010111010101010111010111
10001000001010001010001010000010001
10101111101011101010111010111111101
10101000101010001000101000000010001
10101010111010111111101111111110111
10100010001000001000001000100010001
10111111101111101110101110101011101
10100010000000100010101000101000101
10101011111110111010101010111110101
10001000100000100010101010100010001
11101110101111101110101011101010111
10001010101000101000101000001010001
11111010101010101011101111111011101
10000010100010001000100010000010101
10101110111111111110111010101110101
10100000001000100000101000101000001
10111111101110101111101111101011111
10000010100000101000101010001000001
11111010101011101110101010101111111
10000010101000101000001000100010001
10101110101110101011111111111010101
10100010100010100010001000001010101
11111010111010111111101011101010101
10000010000010000000001010001010101
10111111111111111111111010111010101
10000000000010000000100010001010101
10101111111010111110111011101010111
10101000100010100010001000100010001
10101010101110101010101110101011101
10100010100000101000100000101000001
11111111111111111111111111111111111
