11111111111111111111111111111111111
10001000101000100000001000000000001
11101011101110111111101110111111101
10100010000000001000000010101010001
10111011111110101110111110101011101
10000000000010101000000000000010001
11101111101111101110101110111011111
10001000000010000000101000100010001
10101011101010101111111110111110101
10101010001010100010000010001000101
10111111111011111110111110111011101
10001000000000001000000000101010001
11111111101111111111111110101110111
10101000000000101000100010000000101
10101110111011101011111011101011101
10000000100010001000000000101010001
11111011111111101011111011101010111
10000010101010100010001000001000001
11111010101010111010111011101011101
10100000001010100000001010101010001
10101110111010111111101010101111101
10001000100010001000101010001010101
10111010101110101011101111111010111
10001010100000101000000010000000001
11101010101111101110101110101111101
10001010000000100000101000100010101
10111111111110111011101110101010111
10100010001000100000100010101010001
10101110111011111111111010111110111
10100010001000101010000000001010001
10101110111011101010111110111011101
10100000000000001000001000000000001
11101110111110101010111110101010101
10000010100000101010100000101010101
11111111111111111111111111111111111
