11111111111111111111111111111111111
10000000000000000000000000000000001
10101110101010101011101011111011101
10100010101010101000101000001000101
10101111101111111111101010101110101
10100010000000000000101010100010101
11101111111010101011101011111110101
10000000100010101000101010000000101
11111011101011101010111010101110101
10000010001000101010100010100010101
11111011111011101010101110111010101
10000010000000101010101000001010101
11101010101010101010111110111010111
10001010101010101010001000100010001
11101110101010111010101111101110111
10000010101010100010100010001000001
10111010101111111011111111111110101
10001010101000000000100000000000101
10101010101111101011101011111011101
10101010100010001010001000100000101
10101110111111101110111011101010111
10100010100000000010001010001010001
10111011101111101111111110111111101
10100010001000001000000000000000101
10111011101010101110101011111011101
10100010001010101000101000001010001
10101011111010101011111110101011101
10101010000010101000001000101000101
10111110111010111111101110101110101
10000010001010100000000010101000101
11101011101010101011101111111011111
10001010001010101000101000000000001
10111011101010111111111010111111101
10100010001010000010000010001000001
11111111111111111111111111111111111
