11111111111111111111111111111111111
10000000000010000000100000000010001
11111011111011101011101111101010101
10000010001010001010001000101010101
10111111101010111110111110101110101
10001000100010000010000000100000101
10101010101111111011111110111111101
10100010100010001000000010100000101
10111110111010101111101010111010101
10000010100000101000001010100010101
11111010111111101011111010101110101
10100010001000000010001010100010101
10101111101111111110101110101011101
10000000101000000000100000101000101
10111110101011111111111111101110101
10100010101000001010000000101000101
10101011101111101010111110101011101
10101000000000101000100010001000101
11101111111110101111101011111110101
10001000000000100000001000001000101
10111110111111111111111111101011101
10000010100010000000100000100010001
11111010111010111011101110101110101
10001010001010001000001000101000101
10101011101011101111111011101011111
10100010000010001000101000001000001
10101111111110111010101111111111101
10101000000010100010000000000010101
10111011111010111011111111111010111
10100010001010001000000000100010001
10101110101011101111111110101110101
10001000101000100000100000100010101
10111111101110111110101111111010101
10000000000010000000001000000000101
11111111111111111111111111111111111
