11111111111111111111111111111111111
10101000001000000000000000000000101
10101010101011111111111111111111101
10000010101000100010100010100000101
11111111101011101110101010101010101
10000000001000100000001010001010101
11111111101110111111111011101111101
10001000001000101000100010100010001
10101110101011101110111010101110101
10100000101000101000000010000000101
11111110111110101011101010111011101
10000000001000100000101010100000101
11111110111110101111111110111111101
10100000001000000000000010000000101
10111111101110101110101010111011101
10101000001000100010101010101000101
10101010101010111010101110101110101
10000010101010100010100000100000101
10101011101011111111111111111011101
10101000101000100000101010001010101
10111111111010101011101010101010101
10000010001010101000000000100000101
10101111101111101111111111111111111
10100000001000100000001010000000001
11101111111011111111101011111111101
10101010001000100010001010000000001
10101010101110101010111010111111111
10000000101000101010001010100000101
11111110111110101111101010111110101
10000010001000000000001010001000001
10111011101011111110111010101010101
10001000001000100000001000100010101
11111010101011101111111010111010101
10000010100000100000000010100010101
11111111111111111111111111111111111
