11111111111111111111111111111111111
10000000000000100000100000101010101
11101111111010101111111011101010101
10000010000010000010100010000000001
10101111101110101110111011101111101
10100000100010100000100000001000001
10111011101111101110101110101111111
10001000100010000010000010100010101
10111111101010101111101111111110101
10100010101010101000000010001000001
10101110101011111011101110101010111
10100000001010001000100000100010001
11101010101111101111101111101011101
10001010100000000000100010001010001
11111111111011101011111111101110101
10000000100000101000001000100010101
10111011101011101011111011101111101
10100010101010001010000010000010101
11101110101111111111101011111110111
10000000000000000000001010000000001
11111110111011111111101110111111101
10100010001010101000100000001000101
10111010111110101011111010111110101
10000000001000001010000010001000001
11101111111110111010111011111111111
10100000001000000010100010001000001
10101011111011111111111010111110101
10001010000000101000001000000000101
11101011111110101011111011111011101
10001010000010101000100000001010001
10111010111110101110101111111011111
10001010000010101000000010101000001
11101010111110101111101010101011101
10001000000000000000101000001000101
11111111111111111111111111111111111
