1111111111111111111
1000000000000010001
1111101110111010101
1000100010100000101
1011111110111111101
1000000010001000101
1111111010101010111
1000001010100010001
1011111010111111101
1000001010101000001
1011101010101011111
1010100010001000001
1010111111111011101
1010000000001000101
1010111111101111101
1000100010001000101
1111101110111010101
1000000000000010001
1111111111111111111
