1111111111111111111
1000000000000000001
1110101010101111111
1000101010100000001
1010101010111010111
1010101010001010001
1011101010101011101
1000101010101000101
1111101111111010101
1000000010000010101
1011111010111011101
1010000010001010001
1010111111101110111
1010000000100010001
1010111111101010111
1010100000001010001
1010101010111111101
1010101010100000001
1111111111111111111
