1111111111111111111
1000100000000010101
1011111111101110101
1000101010101010001
1110101010101011101
1000100000100010001
1011101110111010111
1000101000100000001
1110111011101110101
1000100000000010101
1010101111111111111
1010100010000000101
1110101011101110101
1000101000000010001
1011111011101111101
1000101010001010001
1110101010101011101
1000000010100010001
1111111111111111111
