1111111111111111111
1010000000100000001
1010101110101011111
1000101000001010001
1111101111111010101
1000100000001010101
1010111111101110101
1010000000000000101
1011111111111111101
1000000010000000101
1110111010111011101
1010001010001010001
1011101011101010111
1000101000101000001
1110101110111111101
1010001000100000101
1011111011101111101
1000000000000010001
1111111111111111111
