1111111111111111111
1010001010101000001
1011101010101011111
1010000000000000001
1011101111111011101
1010001010001010101
1011101010111110111
1000000000000010001
1010111111101110111
1010101000100000101
1110101011111110101
1000000000000010101
1110101110111011101
1000101000001000001
1010101111111011111
1010100000100000001
1111101111101110101
1000000000100010101
1111111111111111111
