1111111111111111111
1000000000000000001
1011111011111010101
1000100000001010101
1010101110111110101
1010101000001000101
1010101110111111111
1010101000000000001
1010101011111011101
1010101010000000101
1010101111101111111
1010100000100000001
1010101011101010101
1010101000101010101
1011101010111011101
1010001010001010001
1011111111111011101
1000100000000010001
1111111111111111111
