1111111111111111111
1000001000000000001
1110111010101110111
1000000010100010001
1011101011101110111
1000101010000010001
1011111010101110111
1010000010101000001
1011101011111011101
1000101010000000101
1111111111111011111
1000100000000000001
1011111011111011101
1000000000100010101
1011111011101010101
1000100000101010001
1111101011111110101
1000001000000010101
1111111111111111111
