11111111111111111111111111111111111111111
10000000100000100000000010000000100000001
10111110101110101111101110111011101111101
10101000101000100000101000101010001000101
10101011101111111011101011101010111011101
10101010000010000010001010001010001010001
10101011101010111110111010101011101010111
10100000101010001010001010101000100010001
10111110111011101011101010101011111011101
10000010000000100010001000101000001000101
10111011111110111010111111101111101110101
10101000100000001010000000101010001000101
10101110111111111011101110101010111011101
10100010000010001000101000100010001000101
10111011111010101110101111111011101110101
10001010000010100010100000000000101000101
11101010111110111010111111111111101011101
10101010100000001010001000001000100010001
10101010101111111011101110101010111010111
10001010001000000000100000101010001010001
10111011111011111111101111101011101110101
10000010000010000000101000101000100010101
11101110111010111110101010111010111011101
10101000100010100010101010001010100010001
10101011101110101110101011101110101110101
10101000101000001000101010000000100000101
10101110111011111010101011111011111111101
10101010000010100010101000100010001000101
10101011111110101111101110101110101011101
10100010000000101000000010100010101010001
10111011101111101011111110111111101010111
10001000101000001000100000100000001010001
11101110101011111110101110101111111011101
10000010101010000010100010101010000000101
10111010101010111010111011101010101111101
10100010101000101010001010001000100000001
10111110101111101010111010111011111111111
10000010001000001000100010001010001000001
10111011101110101111101111101010101110101
10001000000000100000100000001000100000101
11111111111111111111111111111111111111111
