11111111111111111111111111111111111111111
10000000000000000000000000000000000000001
10101111111010111011111111111110111111101
10100000100010001000000010000000100000001
10111010101011111011101010111011101110101
10001010101010000000101010100000100010101
10101110101111111011101111111010101010101
10101000101000000010000000001010101010101
10101010111011101110111010111110101010111
10101010001000100010100010001000101010001
10101010111011111010101010111010111110111
10101010001000001010101010001010000010001
10111111111111101011111011111011101111111
10000010000000001000001000100010000000001
10111011101011101111101011101110101110111
10001000101000100010001000100010101000001
11101111111111101111111010111110101110101
10001000000000000000001010000010101000101
10101010111010101010111110111010101010101
10101010001010101010100000001010101010101
10101110111011111111101010101010111010111
10100010100010000000001010101010100010001
10111110111010111010101010111110111011111
10001000001010001010101010100000100000001
10111111101110111010101110101010101110101
10001000001000001010101000101010101000101
10111110101111111011111010111010111110101
10000010100010000000001010001010001000101
10101010111110111010101010101010101011101
10101010100000001010101010101010101000101
10101110101110101010111011101011101010111
10101000100010101010100000101010001010001
10111010111011101111111010101010101010111
10100010001010000000001010101010101010001
11101111101110111010111011111011101010111
10000010000010100010001000001000101010001
10101110111011111111101010101011101010101
10101000001000000000101010101010001010101
11101010101010101010101010101110101110101
10001010101010101010101010100010101000101
11111111111111111111111111111111111111111
