11111111111111111111111111111111111111111
10000000000000000010000010000000000000001
10111111111111111010111011111111111110101
10001000000010001000101000000000001000101
11101011111010101111101111101111111011101
10001010000010100000100010001000100010101
10111110101110111010111010111010101110101
10001000100000100010001010100010101000001
11101010111111101110101010101111101011111
10100010000000100010100010000000001010001
10111111111110111010111111111111111010101
10000000100000100010001000100010001010101
11111011101111111111111010101010111011101
10001000001000000010000010101010001000001
10101011101011111010111110101011101010111
10101010001000101010001000101010000010101
10111010111110101011101011101011111110101
10100010100010101010001000101000000000101
10101111101110101010111110111111101111101
10101000100010001000100010000000001000001
10101010111011101111101111111011111011101
10101010100000101010001000100000100000101
10101010101010101010101010101111101111101
10101010101010001000101010001000001000101
10101010111011111111101011111111111010101
10101010000010000000101000001000000010001
10101011111110111010101111101011111111111
10101010000000100010100010001000000000001
10101011101111101110111010111111111111101
10001000000000100010001010000010000000001
11111111111110111011101011111010111110111
10000000000010101000100010000010001000101
10111111111110101110111011111011101011101
10100000100000101000100010001000101010101
10101110101111101011101110101110111010101
10100010001000100000100000100010000010101
10101111111010111110111111111011101110101
10101000001010000010001000101000100000101
10101010111010111110101010101010111111101
10001010000010000000100010001010000000001
11111111111111111111111111111111111111111
