11111111111111111111111111111111111111111
10000000000000000000000000000000000000001
10111110111110111110111010111111101110101
10000010100000000010001010000010000010101
10111010111010101011101010101010111111101
10100010100010101010001010101010000000101
10101110101011101011111110101011101110111
10100010101010001000001000101010000010001
10111110111010101110111110101010111111101
10100000100010100010000010101010001000001
10111111101110111110111111111010101010101
10100000000010100000000010000010101010101
10111110101110111111101011111111101110111
10000010100010000000101000000010000010001
10101110111110111011101111111011111011101
10100010000010100010000000100000001000101
10101010101010101110101110101111111111101
10101010101010101000100010100000000000101
11101111101111101011101110101010101110101
10000010000000101010000010101010101000101
11101111111011111110111110101110101111101
10000000001000100000000010101000100000101
10111110111011101011111110111010111110101
10100000100010001000000010001010001000101
11101011111110111010101010101010101010101
10001000100000100010101010101010101010101
11101110101010111010111011101110111111111
10000010101010001010100000101000000000001
10101011111011101110111011111111101011101
10101010000000100010100000000010001000101
10111011111011111011111110111111111011101
10100000100010000010000000000000100000101
10111111101111111011111111111010101010111
10100000000000100000000010000010101010001
10111110101010101111111011101111101011101
10000010101010100000100000100010001000101
11111110101110111111101011111111101110111
10000000101000000010001000000010001000001
10101110101111111011101011111010101011101
10100010101000000010001000001010101010001
11111111111111111111111111111111111111111
