11111111111111111111111111111111111111111
10000000000010000000100000000010000000101
10111111111110111010111110111110101010101
10100000101010100010100000100010101010001
10111110101011101111101111111011111010101
10101000101010100000000000100010100010101
10101010101010111011111110101110101110101
10000010000010000010100000100010000010101
11111111111010101110101010101111111011111
10001000101010100000101010000000001000101
10111110101010101010111011101111101010101
10001000001010101010100000100010000010001
11101011111011111110111111111111111111111
10000000000010000000000000000010000010001
11101111111111111111111111101111101110111
10000000000010000000000000000010000010001
10111111111111111011111111111110101011101
10100000001000100010000010001010101000001
10101010111010101110111010101010111010111
10101010001010101010001000100010001010001
10101010111010101010111010101110111111111
10101010000010000000001010100010100000101
10111011111111101111111111111110101011101
10000000100010000000100010100010001000001
10101110111011111011101110101011111011111
10101000000010000000100000001010000010101
10101110111011111110111011111111101110101
10101000100010000000100000100010001010001
11101111111110111111101111101011101011101
10000000000010000010000010101000000010001
11111011111110111010101110111010101011101
10000000000010001010100010100010101000001
11111111101110111110101110101111111011111
10000010100010000000100000000010000000001
11111010101110101110111111111011111011111
10101000000010100010100000000010000010101
10101010101110111111111111111110101010101
10000010100010000000000000000010101000001
11111111111111111111111011111111111111111
10000000000000000000000000000000000000001
11111111111111111111111111111111111111111
