11111111111111111111111111111111111111111
10000000000000000000000000000000000000001
10101111111010111010111110111011101011111
10100000001010001010001000001000101000001
11101010111011111011101011111010111111101
10001010001010000010001000001010001000001
11101010101110111110111011101010111110111
10001010100010001000001010001010100000001
10101011111010111010111011101011101110111
10101000100010100010100010001010001000001
11101111111011101110111111101111111010101
10000000001010001000000000100000001010101
11101111101011101111101111111110101011111
10000000101010001000000000100000101000001
10111010111010111010111011111110111010111
10100010001010001010100000001000100010001
10111010101111101010111110111011111110111
10001010101000001010001000001000000010001
10111011101110101110101010111110101010101
10001010001000100010101010100000101010101
11101010111110101110101011111011101011101
10001010100000100010101010000010001000101
11101010111010101010101011111011101110101
10001010100010101010101000001010001000101
10111110111011111111111111111011101011111
10000010100000000000001000000010001000001
11101011111010101010101111101011101110111
10001010000010101010101000001000101000001
11101110111010101111111011111010111011101
10001000100010101000000010000010001010001
11111010101110111111111011111111111011111
10000010101000000000100000100000000000001
10111110111011101010101111111110111011101
10100000001000101010100000100000100000101
10101010101111101011111011101110101111111
10101010100010001000100000100010100000001
11101010101011111110111111101111111111101
10001010101010000000001000000010000000001
11111111111010111010101110101110101011101
10000000000010100010101000101000101010001
11111111111111111111111111111111111111111
