11111111111111111111111111111111111111111
10100000000010101000000000100000101000001
10111011101110101010111111101010101010111
10100010001000101010000000001010100010101
10101011101110101111101111111111111011101
10101010001010000000100000000010000000001
10111110101011101111111010111011101111101
10000010101000000010000010001010000000101
11101010111110111010111111101110101111101
10001000000000001000100000100010100010001
10111011111111111010111011111011111011101
10001000100010101010100000001010001010001
10101110111010101110101011101010111011111
10101010100000001010101010100000000000001
10111010101111101011111010101011101111101
10001000000000101000101010101000100010101
10111111101110101010101010111011111110101
10101010000010101010001010001010001000001
11101011101111101111101011101010111111101
10101000101000101000001010000000100010101
10101110101110111011101110111011101010111
10000000100000100000100010100000001000001
10111110101110101111111110101011101111101
10101000100010000000101000101000101000001
11101110111111101110101110111011111110111
10000010101010101000100010001000001010001
11111010101010101011101110111111111011111
10000000000000001000001000001000000000001
11111110101111101010111010111110111011111
10001010101000101010100010101010001000101
10111011111110111110101110101010101010101
10000000000010000000100010001000101010101
10101111101110111111111111101011111010101
10101000000010000000101000100010100010001
10111110101011101011101010101010101111111
10001000101000001000001010001010101000001
11101110101010101111111110111110111111101
10001000101010100000000010001000000000001
11111011111010101110111111101111101010111
10000000001010101000000000100000001010001
11111111111111111111111111111111111111111
