11111111111111111111111111111111111111111
10000000000000000000000000000000000000001
10111111101110101111101010101011111111101
10000000101000100010001010101010000000001
11101111111011111111101111101010111110111
10001000000000000000100000101010000010001
10101011111011101110101010111110111011101
10101000001010000010101010000010001010001
10101010111010101010101010111110111111101
10101010100010101010101010001000000010001
11111011111111111111111011101111111111101
10000000001000000000000000100000000000101
11101010111111101110101010101110101011101
10001010001000001000101010100010101010001
11101011101111111110101011111010111110101
10001000101000000000101000001010001000101
10101110111010111110101111111011111010101
10101000100010100000100010000010000010101
11101111101110111011111011111010101010111
10000010000010001010000000001010101010001
10101010101111111111111110111010101110101
10101010101000000000000000001010100010101
11101110101110111010111111111011111010101
10001000100010001010000010000000001010101
10111010101111101111101011101111101010101
10001010100010000000101010001000001010101
11111110111111111010111110111110111010101
10000000000000001010100000000010100010101
11101111101010111011111111101010101110111
10000010001010001010000000001010100010001
10111110111011111011111010111110111010101
10100000001000100000100010001000100010101
11111111111011111011101111101110111111101
10000000000010000000101000000010001000001
11101110101110111111101011101110111010101
10001000101000000010001010001000100010101
10111010101111111111101010101010101111101
10100010100010000000001010101010101000001
10111111111010111110111110101110101110101
10100000000010001000100000100010100010101
11111111111111111111111111111111111111111
