11111111111111111111111111111111111111111
10001000000000000000100000100000001000001
10101011111110111110111011101011101011101
10100000100010000010001010001010101010101
11111111101011111011101010111010101010101
10001000101000000010101000100010100010001
10101010101111111110101011101110111110111
10100010001000000000001010001000001000101
10111111111011111011111110111111101011101
10000010000010001010000000100000101000101
11111011111110101011101111111010101110101
10100010000000101000101000001010001000101
10101111111111101110101011101011111011101
10100000000000101010001010101010000010001
10111110111111101011111010101010111110111
10000010100010001000001010001010100000001
10111010101010111011101011101010111111101
10101010101010001000101000100010000000101
10101010101011101010101010111111111110101
10001010001000001010101010001000001000101
11101011111111111010101111101010101011101
10001000000000000010100010001010101000101
10111111111111111110111010111010111110101
10100000001000000000101000100010000010001
10111111101011111111101110101111111011101
10000000101010000010001000101000101000101
11111110101010111010111011101010101110101
10000010101010001010100010101010001000101
10101010101011101010101110101011101011101
10101010001010001010100010101010001000001
10101111101010111010111010101011111111111
10101000101000100010100000101000000000001
10101010101111101110101111101111111111101
10101010001000101000001000100000000000001
10101011111110101011111010111111111111101
10100010000000101000100010001000000010001
10111111101011101110101110111011101010111
10001000101010001000101000100010001010001
11101010101010111111101011101110111111101
10000010001010000000001000000010000000001
11111111111111111111111111111111111111111
