11111111111111111111111111111111111111111
10000000000010001000100010001000101000101
11111111111010101010101111101010101110101
10001010100010100010101000001010000000001
10111010101110111010101010111010101111111
10001000000000101010000010000010101010001
10111110101110101111101111111110101010101
10000000100010001000000010101010101000101
10111111101111101111111110101010101011111
10001010100010000010100010000000100000001
11101010101010101110101110101110101111111
10001000001010100000000010101000100000001
11101111111111111111101110111111101111111
10001010100010001010000010000000100000001
11101010111010101011101011111111111110111
10000000000010100010001010001010001000101
11101111101110101010111011101010101010101
10000010000010101000001010000000100010001
11111111111111111111111111111111101111111
10001000000000000000100010100010101010001
11101111111111101111101010101110101010101
10001000001010000000101010100010000000101
11101110111011101110111010101111111110111
10001000001010001000100000001010001000101
10111111101010101110101111101010101010101
10101010101000101000100000100010101010001
10101010101011111111111111101111101011111
10001000000000000000100000000010000000101
11101111101010111110111110111111101011101
10001000101010001010101000100000001000101
10111110101010101010101010111010111011101
10001000001010100010000010100010001000001
11101111111111111110111110111010111111111
10001010000010001010100000000010001010101
10111010101010101010101111111111101010101
10001000101000101000101010100010000000001
11101010101110101010101010101110101011101
10000010101000100010100000100010101000101
10101111111111111011101110101011101011111
10101000000000000000101000001010001000001
11111111111111111111111111111111111111111
