11111111111111111111111111111111111111111
10101000001000000000101000101000101010101
10101110111011111110101110101011101010101
10000010000000100010000010000000101010001
10111111111111111011101010111110101010111
10100000101000101000001000000010100000101
10111011101110101011101111111110101010101
10100000100010001010001000000000001010101
10101111111010101011111010111111101011101
10001010000010100010101010101010001000001
10111011101111101010101111101010111011101
10000010101010101000000000100010001010101
11111010101010101011111011111010111010101
10000010001010001000001000001000100000101
11101010101011101010111010111011111011111
10001010101000001010001010001010001000101
11101010111111111110111110111010101110101
10101000000000000000100000101010101010101
10101010111111111111111111101010101010101
10001010000010000000101000100000101010001
11111111111011101111101110111110111010111
10001000000000100000100000000010001000001
10101011111011101111101110111111111011111
10100010000000100000100010100010000000001
11111011111110101011111011111010101110111
10000000101000001010101000000000101010101
10101010101010111110101110101110101010101
10101010100010001010000010100010100010001
11101011101111111011101111101011101010101
10101000100000100000100010101000101010101
10101110111011101111101010101011101011111
10101000001010000010001010001010001000001
10101011111011111011111010111011111011101
10001010100000101000001010001010100000101
10101010101111101111101010101110101110111
10101000100000000010001010100000100010001
11111010111110111010111010111010111110111
10000010100000001000100000101010000010001
10111110111010111010111110101011111011101
10100000001010100010100000001000001000101
11111111111111111111111111111111111111111
