11111111111111111111111111111111111111111
10001000101010000000100010001000001000101
11101011101010111110111010111011111011101
10001000001010001010000010101000101000001
10101010101010111010101110101010101111101
10100010100010001000100000001010001000101
11101110111111101111111111111110101010101
10001000000010101000000000000000100010001
10111110111110101011101011111111101111111
10001000000010000010001000101010101010001
11111011111111111111101110101010101011101
10000000000010100010101000001010000010001
11111111101110101010101111101011101110111
10000000000010001000101010101000000000001
11111011111110111110101010101011111111111
10100000100010100000001000001000000010001
10101011101110101111101011111011111110111
10001000000000100000101000001000100000001
11111111111111111011111111111011111011101
10000000000000000000100000101000100010001
11111111111111111110101010101011101110111
10001010101000100010101010001000100010001
11101010101010101110101111111011101111101
10000000001010000000100010001000000010001
10111111111110111010101010101110111111111
10100000001000100010101000101000100010001
10101011111011111111101011101010111010111
10001010100000100000101010001010001010001
10111010101110101110111111101011101010111
10001000001000001000100010001000100000001
10111111111111101111101110111110111111111
10000000101010100000000010001010001000001
10101011101010111010111011101010111011111
10101000001000000010100010001000001000001
10111111101011111110101111101011101110101
10000010101010000010100000001010001000101
10101010101010101110101111111011111011101
10101000101000100010101000001000000000101
11111011111111111111101110101010111011111
10000000000000000000100000101010001000001
11111111111111111111111111111111111111111
