11111111111111111111111111111111111111111
10000000000000000010101010100000100000001
10111111111011111110101010101110111011111
10100000001010100000000010101000100010001
11111110111010111110111110111011101011101
10000010000000001010000010000000001010101
10111111111110101011111011111110101110101
10100010000010100010000000000010100000101
10111010111111101110111110111011101110101
10001000001000000000101010001000101010001
11101010111111101011101011101011101011111
10001010001010101010101000001010100010001
10111110111010101010101011111010101111101
10001010001010001000100010000000100010001
11101010101011111111101110101111101010111
10100000100000000000001000100010001000001
10111111111111111010111011111011111011101
10000010100010000010101010100010100010001
10101010101010111111101010111110111011111
10101000101010101000101000100000001000001
11111011101110101011101011101010101010111
10100000101010000010001000001010100010101
10111010101010111110101111101111111111101
10000010100000001010101000000010000010001
11101011111010101010111111111110111111101
10101000001010100010000000101000000000001
10101010111011111010111111101010111010111
10101010000010001000101000000010001010001
10111111101110101110101011111110111111101
10000000000010100010101010000010100000101
10111110101011101010101011101110101111101
10000010101010001010100010100000001000101
11111110101111101110101110111010101110101
10001000101000100010001000000010101000101
11101110101110101010101110111010101011101
10000010101010001000101000100010101000101
10111011101010101010111110101011111110101
10100000001010101010100010101000001010001
10111011101010111011101110111111101010111
10100010001000100000100000000010000010001
11111111111111111111111111111111111111111
