11111111111111111111111111111111111111111
10000000100000000000100000100000001000001
10111111111111101111101111111110111110111
10000010000000100000000000101000001000001
10101011101011111110101011101011101110111
10101000001000001000101010001010000000001
10101111101110101111111011101111101111111
10100010000010101000000010000010100010001
10111111111011111111111011101110101010101
10001000001010000010001000101010001000101
10101110111110111010111010101010111110111
10100010000010100010000010000000001000001
10111111101010111111111010101010101110111
10000010001010100010000010101010101010101
11111010111010111011101011111011111010101
10000000101010100010001010000010001010001
11101011101010101111111011101110111010101
10001010001000001000100000101010001000101
11101010101010101011101111101010111011111
10001010100010100000101000001000101010101
11101011111110111010111011111110101110101
10101010101000001010000010000010000000101
10111110101111111111101010111011111011101
10001010000000000000001000100010001000001
10111011111110111110101011111110111110111
10001010000010001000101010000010000000001
10101011111010111011101110111011101011111
10101010000000001010001000101010001010001
11101011111010111011111011101110101011101
10100000001010100010100000000000101010001
10111110101111111010101111111011111010101
10100000100010001010001000100010000010101
10101110111010101010111110111011111010111
10101000100000100000101000100010000000001
10101011111111101111101011111011101111111
10101000000000101000100010101000100000101
10111011111111101011101110101111111010101
10001010000010000010001000001010000010101
10111011111011111011101010111010111010101
10000000100000000000000010100000100010001
11111111111111111111111111111111111111111
