11111111111111111111111111111111111111111
10000000000000000000000000000000000000001
10101110111010101111101010111111101111101
10100010001010100000101010100000000000101
11101111111111111010101111101110111011101
10000010000000000010100000100010001000101
11111110101011101110111010101011111011101
10000000101010000010100010101000100010001
10101111101110101011101011101110111111101
10101000000010101010001000100010000000101
10101110101010101110111010101110101011111
10100010101010100010100010101000101000001
10101110111110101110111011111110101110111
10101000000010100010001000001000101000001
10101110101010101010111011101110101111101
10101000101010101010001010000010100000101
10101010111011111110101010101011101110101
10101010100000100000101010101010000010101
10101011101011101111101011111110111111111
10101000101010000010001000100000000000001
10101011101111111011101010101011111110101
10101010001000000000101010101000001000101
11111010101110101111101110111010111010101
10000010100010100000101000100010100010101
10101011111011101011111011111010101110101
10101000001010001000100000100010100010101
10101011111110111110111111101110101111101
10101000000010000010100000000010100000101
11111111101111111111101011111111101110101
10000000000000001000001000001000001000101
10111011101010101110101111101110111011101
10001000101010100010100000100010100000101
10111110101010111110101111111011101111101
10100000101010000010100000001000101000001
10101111111011111110101010111011101110101
10101000000000000010101010100010001000101
10101010111011111110111111111110101110111
10101010100000000010000000000010101000001
10101011101110111010111110111111101010101
10101000100010001010100000001000001010101
11111111111111111111111111111111111111111
