11111111111111111111111111111111111111111
10000010000000001000001000000000000000101
10111010111011101010111011111110111110101
10100010001010001010001010000010000010001
10111111101011111011101011111011111011101
10000000001000000010100010000000001010001
10111111111111111110111110111111111010111
10001000000000001000000000100000000010101
11101111111110101110111110101111111110101
10100000000000101000101000101000000010001
10111111111111101011101011101011111011101
10000010100000100010000000101010001010101
10111010101110111110111111101010101010101
10001000100010000010000010001010101010101
10101011111011111011101110111010111010101
10101010001010001000001000100010100000101
11101110101010101111111011101110101111101
10001000100000100000001010000010101010001
10111011111111111111111010111010101010111
10000010100000000000000010001010000010001
10111110101111101111111111101011111111101
10000010100010001000000010001000000000001
11111010111011111011111011111111111111111
10000000001000001010001000100010000000001
10111111111111101010111110101010111111101
10001000000000001000100000101000100010001
10111011111110111110101110101111111010111
10100010001000100000100010101000000010001
11101110101011101111111011101111101111101
10001000101010001000101000100010001000001
10111110101010111010101110111010111111111
10100000101010100010000010001010000000001
10101111111010111011101110101011111111101
10100000000010000010101000101010000010001
10101111111111111110101011111010111010101
10101000000000000000101000001010001010101
10101011111111111011101111101011101010111
10101010000000101000100000101010001010001
10111010111110101110111110101010111011101
10000000100000000010000000100000100000001
11111111111111111111111111111111111111111
