11111111111111111111111111111111111111111
10000000000000000000000000000000000000001
11101010101011111010111011101011111011101
10001010101010000010001000101000100010001
11101110111010111111101111101110101111101
10000010100010000000100000101000101000001
10111111101110101011111111101011111110111
10100000000010101010000000001010000000001
10101010111011111010111111101111101010101
10101010001010000010001000000010001010101
10101110111011111011101111111110111111111
10101000001010000010000010000000000000001
10111010101011101110101111111110111111101
10001010101010000010100000001000100000001
10111011101111101011111010101110101110101
10100010000010001000100010101000100010101
10111010111111101111101010111010111011111
10001010000000101000001010001010001000001
10101010101111111111111111101111101011101
10101010100000000000000000100010001010001
11101110101111101011101111101110111110101
10000010100000101000100000100010001000101
10101110101110101010101110111110111010101
10100010101000101010100010001000100010101
10111011101011101110101010111111111011111
10100000101000101000101010000010000000001
10111011111010101011111011101110101010111
10100000100010101000100010001000101010001
10111011111110101010111011111010101011101
10100000001000101010001000001010101010001
10111010101110101110101010101110111111101
10100010100010100010101010100010000010001
10111110101011111110111110111011101111101
10100000101010000000000010100000100000101
10111110111111111111111010101011101010101
10000010000010000000000010101000101010101
10111010111010111010111010101011101010111
10001010001010001010100010101010001010001
10111010111011101110111010111010111110111
10001010100010000010001010100010001000001
11111111111111111111111111111111111111111
