11111111111111111111111111111111111111111
10100010101000100010000000101000101010001
10111010101110111011111110101011101011101
10000000001000100010100010001000100010001
11111011111011101110101010101010101110111
10100000101000100010101010101010000010001
10111011101110101110101110101011101110111
10101010101000100010000000100000100010001
10101010101110111011101111111110111011101
10000000101000100000001000001010100010001
10111111101011101110111011101010111010101
10000000000000000010000000101000100000101
11111110111111111111111111111111111111111
10001000101010001000101000100010001010101
10101110101010111110101011101110101010101
10101000001010001010001000100000100010001
11101011101010111010101010111111111011101
10000000101000000000100010100010000010001
11111111101111111011111111101010111010111
10000000101000001010001000101000100010001
11111011101010111010101011101110111011101
10001000101010001000100000101000100000001
10111011101110111110111111111111101111101
10001000101000001010001000100000000010001
11101110101110101011101011101111111110111
10000000001000100000000000101000101010101
11101111111110101011101110101011101010101
10000000001000101010001000100000001010001
11111110111111111011111111101011111010111
10001000000010100010001010101000000010001
10101011101010101010111010111011111111101
10100000101000101010001000101000001010001
11101111111011101010111010101011111010111
10000000001000001000000010100010001010101
11111111111111111111111011101011101010101
10000000000000000000000010001010000010001
10111110101110111110111010101011101010111
10101000101010000010100010101000001010101
10101010101010101010111010111011111110101
10001010100010101010100000100000000010001
11111111111111111111111111111111111111111
