11111111111111111111111111111111111111111
10000010101000001010001010001000001010001
10101110101110101010111010101110111011101
10100000100000100000000000101000100010101
10101010111111111111101111111110101010101
10101010100000101010000000001000001000001
10111111101110101011111110111011101011111
10000010100010000010100000001000101000001
11111010111010111110111011111011111111101
10100010100010101010100010101000001000101
10101010101110101010101010101111101110101
10001000000010000010101010001000001000001
11111011111111111010101110111010101011111
10000010101000101000100000101010101000101
10111010101011101010101110101111101010101
10100010100000000010000010001000001010001
10101110101111111111101111111110111111101
10100000101000100010001000001010101010001
10111111101011111011101111101010101010101
10100000100000000010001000000000001000101
10101011111111111010101011101011111011111
10001000100000000010100000101000001000001
11111111111111101111111111111111111111111
10001000100000101000000010000010101000101
11101011101111101010101010111010101010101
10000000000010101010101000100010100010101
11101111101110101110111110101110101011101
10001010100000100000100010100000101000101
10101010111110101010101011101111101110101
10100000100000101010001010001010101010101
11101111111110111111111010111010101010101
10000000100000100000000010000000001000101
11101111111111101111111011111111101111101
10001000001000000010000010101000100010101
10101111101110101110101110101010101010101
10100000001000100010100010000010001000101
10101011111011111011111011111111101111101
10101000100000100010001010001010000000101
10101011101110111010111010101010101010101
10101000001000100010000010100000101010001
11111111111111111111111111111111111111111
