11111111111111111111111111111111111111111
10001010001000100000000010000010000000001
10111011101011111110111010111111101110111
10000000001000001010100010101000101000001
11101011101110101010111110101011101111101
10001000100000100000000000100010101000001
10111111111010111011101111111010101010111
10001000000010100010001000001000001010001
11101110101011101010101011101011101110101
10101000101010101010100010000000100010101
10101011111110101111101010101110111111111
10101000101000000010001010100010000000101
10101111101111111111111011111110111111101
10000010000010100010100000001000001000101
11101110111010101110111011101011101110101
10100000101000001000000010101010000000001
10111010101010111010111010101111111011111
10101010001010100010101000101000000000001
10101111111110111111101110111011101111101
10100010100010101010101000101000100000101
10101110111010101010101111101111111110101
10100010000000000000100000100000000010101
10101010111011111111101111101110101111111
10101000001000000000100000000010101000101
10101111101011101111111110111010111010101
10100010001000100000000000101010001010001
10101111111011111111111110101011111111101
10101010001000100000101010100010001000001
10111010101110111010101011101011101011101
10001000100000000010000000101000001000101
11101110111011101111101111111011101011101
10001010101000100000100010001010100010101
10101011101011101110101110111110101110111
10100000000010000010100000100000000010001
10111011101010111011101011111010101111101
10101000101010001010101010100010100010101
11101011101110111110111010111011101110101
10001010101000100000100010100000100010001
11101010101111111010111010101011111011101
10000000100000000010100000101000001000001
11111111111111111111111111111111111111111
