11111111111111111111111111111111111111111
10001000100000000000100000000010000010001
10101010111011111110111111101010111010101
10100010000010001000000000001000101000101
10111111111010101111111111111111101111101
10100000000010100010001000100010000000001
10111111101110101011101010101110111111111
10100000001000101000101010100000100010001
10101111111110101110101010111111101110101
10100000000000100010000010100000001000101
10111111111111111011111110101111111010101
10100000101000101000000010100000001010101
10101110101010101111111110111011101011101
10100010100010101000000010000000101010001
10111010101110101011111011111111101010111
10001010101000101010000010100000000010001
11101010101011101010101110101111111111101
10100010101000001010100000100010000000101
10101110101111111010111111101010111110101
10001000100000001010000000001010001010001
11111011111111101011111111111111101011111
10000010001010001010000000001000100000101
10111111101010111010111110111010111110101
10100010001010000010100000100010100010001
10101010111011111110101111101110101111101
10101010001000100000101000001000100000101
10101010101110101011101011111011111110101
10101010100010001010001010001000100000001
10101010111011111010111010111110101110111
10001010100010001010001000100010001010101
11111010101110101110111111101011111010101
10001000100000101000100000001000001010101
10111011111111101011101010111111101010101
10100010001000101010101010000010101000101
10101110101010101010101111111010101011101
10000010100010100010100010001000101000001
11111011111110111110111010101110111011101
10000010000000100000100010100000001010001
10111110111111101110101110111111101010111
10000000000000100010000010000000100010001
11111111111111111111111111111111111111111
