11111111111111111111111111111111111111111
10000000000000000000000000000000000000001
10101010111110111011101110111110111110101
10101010100000100000100010000010001000101
10111111111010101011101111111011101110111
10000010000010101010001000000000100010001
10101111101010101111101111101110101111101
10101000001010100010000000100010100000101
10101110111111111110111010101010101110101
10100010000000000010100010101010101000101
10111110111110101011111111111011111010101
10100000100000101000001000000010000010101
10101011111111101110111111101010101111101
10101000000000101000001000001010101000001
11101110111111101111111110101110101110101
10000010100000000010000000100010101000101
11101010111110111011111110111010101111101
10001010001000100000001000001010100000101
10101011111111111111101110111010101010101
10101000001000000000000010100010101010101
10111010101010101010111010101010101010101
10001010101010101010001010101010101010101
10101011111110111110111011111111111010111
10101000000010000010100000000000001010001
10111011101111101110101110101011111111101
10001000101000001000101000101000100000001
10101011111110111111111011101011111010101
10101010000000000000001010001010000010101
10101110101110101111101011111010111011101
10100010101000100010001010000010001010001
10111111101110111010111110111011111110101
10000010001000100010000010001010000000101
10111110111111111110101010101011101010111
10001000000000001000101010101000101010001
10101011101010111011101111101111101011101
10101010001010100000100000101000001000101
10111111111011101111111011101010111110101
10100000000010001000000010001010001000101
10111010111111101011111011111010101111111
10001010001000001000100000100010100000001
11111111111111111111111111111111111111111
