11111111111111111111111111111111111111111
10000000000010100010000000100000101010101
11111110111010111010111111101110101010101
10100010100000000010001000101000100000101
10101111101011111110111110111010101111101
10000000001010000000000010001010101000001
11111110111110111111111110101011101011101
10101010000010000000100010100000100000101
10101010101110101010101111101111101110111
10000000100010101010001010000000101010101
10111111101111111011111010101111101010101
10001010100000000000001000101000000010001
10101010111010111110111111101110111011101
10101000101010001000100000001000100010101
10101011101111111110111111101011111010101
10100010001000001000100000000010000000101
10101110101010111010101011111011101111111
10101010100010001010101010100010000000001
11101011101110101110111010111110101110111
10000010001000100010000000100000101010101
11111111101111101110111010111111111010101
10000010000010001010100010100000101000001
10111111111011111011101110111110101110101
10000010000010001000100010101010100000101
10101011111010111011111010101010101110111
10101010000010000000100010100010001000001
10101110111010111010101110101010111010101
10101000001000100010100010101000001010101
11101011101110111110101111111010111111101
10100010101010001000001000000010001000101
10111010111010111011111110101010111011111
10101010001000101010100000101010100000101
10101110111110101010101011111111111110101
10001000001000100000101010001010000000001
10111011101111111110111010101011111110111
10001000100000001000100010101000000000101
10111011111011101011101011101010111111101
10001000001000100010001000100010001000001
10101111101111111011111011111011101110111
10100000000010000010000000000010000000001
11111111111111111111111111111111111111111
