11111111111111111111111111111111111111111
10000010000010000010000000000000000000101
10111011101010101110111111111111111110101
10001010001010100000000000100010000000001
11101010111011111110111110101011101111101
10101000001000001000100010001000101000001
10101111111111101111101110111110111011111
10000010000000100000100010001000100010001
11111110101110111110111011101011101111101
10000000100010100010001000101000100010001
10101111111110101110101011101110111010111
10101000001000101000101000100010001010001
10111011101011101011101110111011101011101
10000000101000101000101010001010001000101
11111111101110101110101010101011111110101
10000000001000100000100010100010000010001
10111111111011101111111111111110111011101
10000000001000101000100000100000001000001
11101111101110101010101110101111111111111
10001000100010100010001000100010001000001
10111110111010111111111011101010101011101
10100000101010000010000010001000101010001
10111010101011111010111111111010101010111
10001010001010001000001010001010100010001
11101011101010111111101010101010111111111
10001000100000100010001000101010001000001
10111110111111101011111011101011101011101
10001000100010001000100010001000101010001
11101111101010111110101110111010111010101
10000000001000100000101000100010000010101
10111111101111101111111010101111111111101
10000010001000100000100010100010001000001
11111010111010111110101111111110101011111
10100010001010000010101000001000100010001
10101111111011111110101011101011101111101
10001010000000100000100000101010100000001
10111010111110101111111110111010111010111
10100010100010100000000000100010000010101
10101011101010101111101111101110111110101
10001000001000100000100000001000100000001
11111111111111111111111111111111111111111
