11111111111111111111111111111111111111111
10000000000000000000000000000000000000001
10111111101010101011101111111011111110101
10000000101010101010000000001000000010101
10111111111110111110101010101011101110101
10100000000000001000101010101010000010101
10101011111011111010111010101111111010101
10101000100000001010001010100010000010101
10111111101111101010111110111011101110101
10100000000010001010001000100000101000101
11101011101011101011111111111111111111101
10001000101000101000000000000000000010001
11101010111011101110111111101011101010101
10001010100010000010001000001010001010101
10111010101010101111111011111110101111101
10100010101010101000000000000010101000001
10101110101110101011101111101011111011111
10101000100010101000100000101000100000001
10101111101011111010101110101110101110101
10100000101000001010100010101000101000101
11111011111110101010111011101111101110111
10000000001000101010001010000000101000001
11101110101111111011111011101010101110101
10001000101000000000001010001010101000101
10101011101011111111111011101010101011101
10101010001000000000001010001010101010001
11101010111110111011101110111011101011111
10001010100000001010000010100010001000001
10101110111111101111101111101010101011111
10101000100000000000100000101010101000001
11101111101111101011101110111010101111101
10000000100000101010000010001010100010001
10101111111010101111111110111110111110111
10100000001010100000001000000010001000001
10111011101010101011101010101011111110101
10001000101010101000101010101000001000101
10101010101111111111111110111010101011101
10101010100000100000000000001010101000101
11101011111110111110111011101011101010111
10001010000000000010100010001010001010001
11111111111111111111111111111111111111111
