11111111111111111111111111111111111111111
10100000001000101000000000000000000000001
10111110111110101010111110111110111110111
10000010000000000010001010000010000010001
10101110101010111011111010101011101111111
10100000101010100000100010101010000010101
11111010101110101011101011111110111010101
10001010101000101000001000100000001000001
11101010101110111010111111111110111011111
10000010100010100010000000100010101010001
11111111101111101110101111111011101111101
10000000000010001010100000000010100010101
11111011101111111011101010111110101110101
10000010000010001000101010100000000010001
11101111101110111110101111111110111110111
10001000000010000000000000000010100000001
11101111101110101010111011101110101110111
10000010001000101010100000100000001000001
11101010111011101111101111101111101111111
10001010100010000010000000100000100000101
11101111111111101110111011101111101111101
10101010001000000010100010000000100000101
10111010111010101110111011101010111111101
10000000000010100010100010001010001000001
11111111101111101111111011101010111011111
10000000100010000010000010001010000000001
10111110101110111011101110101110111110101
10100000000010001010000010100010001000101
11111011101010111011101110101110111010101
10100010001010100010001000100010001010101
10111010111111101111101010111010101011101
10100010101010001000101010100010101000101
10111011101011101011111111111010111110101
10000000000010000000000000001010001010101
10111011111110111110111010111011101010101
10100000001010001010001010100010000010101
11111010111010111010111010101011111011111
10101010000010000010101010101010100000001
10101010101110111110101010111110101111111
10000010101000000010100010000010000000001
11111111111111111111111111111111111111111
