11111111111111111111111111111111111111111
10000000000000001000001000000000001000101
10111111111111101011101010111111101010101
10000000001000101010100010100010001010001
11101111101010101010111110101010111011101
10001000101010100000100010101010100010001
10111010111010111110101010101110111010111
10001010100010000010001010100000000010001
10111010101111111010111110111011111111101
10100010001010000010100010001000100000101
10101111111010111111101011101111101110101
10100000100010000000001000100000001010101
11111110101011111111111110111110111010111
10000000101000100000000000000010000010001
10111111101110101111111111111010111111101
10100000101010001000000000001010100000001
10101111101011111011111111101011101111101
10100000001000001010000000101000101000101
10101111111111101010111111101110101010101
10100000100010001000100000100010101010001
10111110101010101110111110111010101011111
10001000101010100010100000100010001010001
10101110101010111010101111101111111011101
10100010001010101010101000001000001000001
10111011111010101010101110111011101111101
10101000001010100010100000100010000000101
10101111101010101110111111101110111111101
10100000101010101010100000001000100010001
10111110101010101010111011101111101010111
10100000101010100010001010001000001000101
10101011101010111111101010111011111111101
10001010001010100000101010001010100000001
11111010111010101011101111101010101110111
10100010101010001000100000101010100010001
10101110101010111110111110101010111011101
10000010100010100000000010101010000010001
10111110101111101110111110101011111110101
10100000100000001000100000101000000010101
10101111111111111111101111101111111010101
10100000000000000000001000000000000000101
11111111111111111111111111111111111111111
