11111111111111111111111111111111111111111
10000010100000100010000000101000000010001
10101110111011111011111011101110111011101
10100010001000100000000000101010101000001
11101110111011111111101111101011101010111
10000010000010101000101010000010000010101
10101111111010101011101011111011101010101
10101000100000100000001010001010001010001
11101011111011111110111010111011111011111
10001000100010100000100000001000100000001
10101011111010111010111010111011101111111
10100000001000101010101010100000000010101
11101011111011101110101011111110111110101
10001010100010101010100000101010001010101
11111010101110101010101111101010111010101
10000010101010001010000000100010100000101
11111010101011101011101111111010101111101
10100000000000100010001000101000000000001
10111111111010111010111110101010101111101
10100010101010100000101010000010101000101
10111010101011111110101011101110111011101
10000000001010001000000010100010100000101
11111110101010111111101010101111111011111
10000010101010100010001010000010001000101
11111011101010101111101110111111101011101
10000000000000000000000000000000000000001
11101111111110101111101110111111101110111
10101010000000100010001010100010100010001
10101010101010101111111011111010101111101
10000010101010100010001000000000100000101
11101111111110101011101010101110111011111
10001000000000101000000010100010001000001
11101111111111101011101111111110111011101
10001000000000001010100000001010001010001
11101111101110101110101110111010101011101
10000010101010100010000010000010101000101
11111110101011101111101011111110111111111
10000000001000000000101000000010000000101
10101111101111101110111110101110111110101
10101000000010001000000010100010000010001
11111111111111111111111111111111111111111
