11111111111111111111111111111111111111111
10100000001000000010000000100000000010001
10101110111011101011111010111010111110101
10001010001010001000000010001010100000101
10111011101010111111111111101010101111101
10100000100010001000000010001010100000101
10111010111111101011101010111011101111101
10000010100000001010101010100000001000001
11111110101111111010101110101111111011101
10001000100000001010100010101000001000101
10111011111111101010111010101111101110101
10100010000010001000001000100000000010101
10101110111110111111101111111011111010111
10001000001000100000001000001010001010001
10111111101011111110111010111010101111101
10000000101000000010001010100010100000001
11111110101111111011101011101110111111101
10000000101000000010101000000010100000001
10111111101011111110101111111110101111111
10000000001000100000100010001000101000001
11111111101110101110111010101011101111101
10001000001010100010001000100010000010001
10111011111010111011111111101111111010101
10000010000010001000000010001000001000101
10111111101011101011101110111011101111101
10000000101000101000101000101010100000101
11111110101011101110101011101110111110111
10100000101010001000100010001000000010001
10101111111010111111101110101011101111101
10001000000010100000101000101000101000001
10111011111010101110101011111110101011111
10100000100010001010100010000010101000001
10111010111011111010111110111010101111101
10001010001000001010001000101000100010001
11101111101111101011101011101111111010111
10101000100000100010001000100000001000101
10101010111110111010111110101111101111101
10101010001000101010000010100010100010001
10101011101011101011111010111010111011101
10000010000010000000001000000010000000001
11111111111111111111111111111111111111111
