11111111111111111111111111111111111111111
10001010001000100000001010101000101000101
10111011101011111111101010101011101110101
10000000000000100010100000100010001000001
11111111101111101010101111101110111110101
10100000001010101000101010100010001010101
10111111101010111110101010101110111011101
10000000000000000010000010001010100010001
11111010111011101111101111101010111011101
10001010101000101010001010101000100000101
11101011101011111011101010101110101111101
10000000100000101010000010001000000010001
10101011101010101011111011101110111111101
10101010001010000000000000100000001010001
11111111111010111111101111101010111011101
10001010100010001000001000101010000000001
11101010111110111111101110111111101111111
10001000000000100000001010101010000000101
10111111111011101111101010101011101110101
10101010000010001010000000001000000010101
10101011111111111011101111111010111011101
10000000000010000000000000100010100000101
10101111101110111111101011111111111011101
10101010001010100010101010100010000000001
10111011101011101110101110111011101010101
10100000001000000000000000101000101010101
10111011101110101110111011101110111011111
10101000100000101010100000101010001000001
11101011101010111011111110101010111010101
10000000101010001010100000101010000010101
11111110111011111010101110101010111111111
10001010100010000000101010101000000000001
10111011101111111110111010101010111110101
10001000001000001000100000000010001000101
10111111111110111110101110111010111111111
10001010101010000010001000001010000010001
11101010101010101010111110101111101110111
10000000000000101000101000101000000000001
10101110101110111010101110111110101110101
10101000101000001010100000001000100010101
11111111111111111111111111111111111111111
