11111111111111111111111111111111111111111
10000000000000000000000000000000000000001
10101010101011101111111110111111101010111
10101010101000100000000010100000001010001
10101011101111111110101111101110111011111
10101000100000001000101000001000001000001
11101110111011111010101010101010101010101
10000010001000100010101010101010101010101
10101110101010101111111010111110101111101
10100010101010100000001010001000101000001
10101010111111101110111011101010111110101
10101010100000001000001010001010000010101
11101010111011101111111111111111111111101
10001010100010000010000000000000000000001
11101010101111101010101111101110111110111
10001010100000101010100010001000000010001
11101011101010111110101011101010101011111
10001010001010000010101010001010101000001
11101010111010111010111010101111111011101
10001010001010100010001010100000001000101
10111110111010111010111110111110101011111
10100000100010100010001000100000101000001
10111111111111101111101010111110111111101
10000000001000000000101010000010000000101
10101110111010111110111011111010111011101
10100010100010100000100010000010100000101
10101111111011111111101111101110111010111
10101000000000000010001000000010001010001
10101111111111111111101010111110111110101
10100010000000000000001010000010001000101
10101010111110111011101010111110111011101
10101010100000001010001010001000001010001
10101011101111101010111111101111101111101
10101000100010001010100000000000101000001
11101110101010111011111011101011111011101
10001000101010100000001010001000001010001
10111010101111111010101110101011111110111
10001010100010000010100010101010000000001
11111111101011111010111010111010101011101
10000000001000001010001010001010101000101
11111111111111111111111111111111111111111
