11111111111111111111111111111111111111111
10000000000010000010001000100000100010001
11101111111010101010111010101110101010101
10001000000010101010100010100010101000101
10111111111111101010101110111010101011101
10100000000000001000100010100010001010001
10101110111010111111111010111011101110111
10001010101010100000100010001010000010101
11111010101011101110101111101110111010101
10001010001000001000100010100010101010001
10101011111011111011111010101010101011101
10100010000010001010001000101000001000101
10111110111110101010111011101111111110111
10100010001000101010000010001010000010001
10101011111011101011101110101010101111101
10101000001000100010001000100010100000101
10101111101110111010111011111110111110101
10000010001000100010101000000010000010001
11111010111011101110101111111111111011101
10001010100010000010100000100000100000101
10101010101110111010111011101110111110101
10100010001000100010000010001000000000101
10111111111010101111111110111011111111101
10100010001010101000100000100010001010001
10101110101110101011101111101111101010111
10101000100000101000101010000000001010001
10101011111111101110101010111110111010111
10001000000010100010100010100010001010001
10111111111010111010111110101011101011101
10001000001010000010000010101010101000101
11101011101010111110111110101010101110101
10001010001010001000001000101000101000001
10111011111011101111101011111010111011111
10100010000010001000101000001010100010001
10101010111110111010101111101010101011101
10101010000010001010100010001010101010001
10111011111010111010101010111010101010111
10000000100010000010101000101010001010001
11111110101111111111101111101011111111101
10000000100000000000000000100000000000001
11111111111111111111111111111111111111111
