11111111111111111111111111111111111111111
10001000000000000000100000000000000000101
10101011111111111011101110111111111110101
10101010000000001000000010100010000010101
10101010111011101111111110101010101110101
10101010100010001000100000101010100010101
10101011101110111010101110101011111010101
10101000001010100010100010101000100010101
11101111111010111010111010101110101110101
10001000000000001010001010100010100010001
10111011111111101011111011101110111011101
10001010001000100010001000001000100010001
11101011101010111010101011111011101110111
10001000001010001010101010001000101000101
10111111101011101010101010111110101011101
10000000001010101010101000100010100010001
10111111111010101110101111101010101110101
10001000001010000010100000101000100010101
11101011111011111010111110101111111011101
10000010000010001000100010001010001000001
10111110111110101110101011111010101111101
10101000100010100010101000001010100000101
10101011101010111011101111101010111110101
10001010001000100010001000001000101000101
11111010111111101110111011111011101011101
10001010001000100000100000001010001000101
10101011101011111011111111101011101110101
10100010001010000010001000001000100010001
10101110111010111110101011111110111011111
10101000100000100000101000100010001000001
10101011111111101111101110101011101011101
10101010000000001000100010101010001000101
10101010111111111010111010111010111111101
10101000100000001010000010001010100000101
10111111101111101111111111101010101110101
10000000001000001000001000001010101010001
10111010111111111011101011111010101011101
10100010100000001000100010000010001000001
10101111101111101110111110111111111011111
10100000000000100000100000000000000000001
11111111111111111111111111111111111111111
