11111111111111111111111111111111111111111
10000000100010000000000000000000100000001
10101110101110111111101111111010101111101
10101010100000001000101000000010001000101
10101010111110111010101011101111101010101
10101000100010100010101000101000101010101
11101011101010101110101110111010111010111
10001000001010101000100010001010000010001
10111111111010101110111111101011111111101
10000000101010100010000010001010000000101
11111110101011111011111010111010111110101
10000000101000000010001010000010100010101
10111111101111111110111010111110101010101
10100000100010000000100010100000101000101
10111110101010101111101110101111101111101
10100010001000100000001000101000001010001
10101011111111101111111111101011111010101
10001000100000100000000010001010000000101
11111010101110111111111010111011101111101
10001010001000100010001010101000101000101
10101110111011101011101010101110111010101
10100010001010001000101010100000001010101
10111011111010111110101010111111101010101
10001000001000100010100010000010101010001
11101111101011111010111011111010101011101
10001000101000000010001010000010001000101
10101110101011111111101010111110111110101
10100010101010000000101000100000000000101
10111110101110111110101111111111111111101
10000000100000100000101000000000000010001
11111111111111101111101011111011111010111
10000000001000100000101010001000101010001
11111110101010111110101010101110101011101
10000000100010100010100010100010101000101
10101111111111101010111110111010101110101
10101000001000001010000010001010101000101
10111011101011111011111011101010101011101
10000010101010001000001000101010001010101
10111110101010101110111110101011111010101
10000000100000100010000000001000000010001
11111111111111111111111111111111111111111
