1111111111111111111111111111111
1000001010000000100010100000001
1011101010111110111010101111101
1000100010100010001000001000101
1111101110111011101011101010101
1000001000100010001000100010101
1010111011101110111111111110101
1010001010000000100000001000101
1011101110111111101111111011101
1010001010100000100010000010101
1010111010101110101010111110101
1010100010001000101000100000101
1010101110111011111111101011101
1010101000100010000010101000001
1011101011101110111010101110111
1010001010001000100000101000101
1010111010111011101111101010101
1000101010100010001000001010001
1110101010101110111011111011111
1000000010001000100010000000001
1011111111111011101110111111111
1000000010100010101010000000001
1111111010101110101011111111101
1000101010000000001000001000101
1010101011111111111110101110101
1010101000100000001000100000001
1110101011101111101010111111111
1000100010001010001010000010001
1011101110101010111011111011101
1000001000100010000000001000001
1111111111111111111111111111111
