1111111111111111111111111111111
1000101010100000000010100000101
1010101010101011111010111011101
1010000010101000101010001000001
1111101010101111101010101010101
1000101010100000100010100010101
1010101010101111111110111111111
1010001000001000000010100000001
1011101010101110111010101110111
1010001010101000001010001000001
1111101010101011101010101010101
1000001010100010001010101010101
1011111111111111111111111011111
1000100010100010001010001000101
1011101010101010101011101011101
1000101000001010100010000000001
1110101111111110101110101110101
1000101000000010100010101000101
1110101010101010111111111111101
1000100010101010000000100010001
1011101111111111111010111010111
1000101000100000000010100010001
1011101010101110101010101111101
1000000010000010101010100000001
1110101110111011111010111011101
1000101000100010000010000010001
1111111111111111111110111111111
1010100000001000000000001000101
1010101010111010101010101010101
1000001010000010101010100010001
1111111111111111111111111111111
