1111111111111111111111111111111
1000000010000000100000001000001
1010111010101111101111101010101
1010101010101000100000101010101
1110101011101010101111101010101
1000101010001010101000100010101
1011101010101010101010111010111
1010000000101010101010001010001
1010111111111010101011111011101
1010100000100010001010000010001
1011101110101111111010111110111
1000100010001000001010000010101
1010111011111111101011101110101
1010001010001000101010001000101
1011101010101010101010111011101
1010001010101010001010100010001
1010111010101010111010101110111
1010100010100010100010101000001
1110101110111110101111101011101
1000101010001000100000101010001
1011101010101111111110101110101
1010001010100000001010001000101
1010111010111110101011111011101
1010100000001000101000100010001
1010111111111011101010101110111
1010100000100010001010001010001
1010101110101110111011111011101
1010001010001010100010000000001
1011111011111010111010111111111
1000000000000000000010000000001
1111111111111111111111111111111
