1111111111111111111111111111111
1000000000001000100000001000001
1111101111101010111011111010101
1000001010001010001000000010101
1011111010111011101011111110111
1000100000000010101000000010001
1010111111111110101111111011101
1010000010001000100000100010001
1011111010101110111110111110101
1010000010100010000010100000101
1010111011111010111010101111101
1010100010000010001010101000001
1010101110111111101110101011111
1010101010000000100010001000101
1010101011111110111011111110101
1010100000000010100000000010001
1110111111101110101111111111101
1000100000001000100000000010001
1011111111111011101111111010111
1000000000000010001000001000101
1111111111111110111010111111101
1000000000000010001010000000001
1111101110111011101111101110111
1000101000101010101000100010001
1010111011101010101010111110101
1010000010000000100010000010101
1011111011111011111111111011101
1000001010001010000010001000101
1011101110101110111010101110101
1000100000100000001000100000001
1111111111111111111111111111111
