1111111111111111111111111111111
1000101010100000100000001010001
1011101010101111101111111010111
1010100000000010100010100000001
1010101111111110101110111010111
1000100010001000100000100010101
1011101110101011101111101111101
1000001000101010000000000010001
1011111010111010101110111111101
1010101010000010100010001010101
1010101110111110111111111010101
1010100010001010100000000000001
1010101110111010101011111011111
1000000000000000001010001010101
1110101110101010101110111110101
1000100010101010101000000000001
1010101111101110111011111010101
1010100010001010000000100010101
1010101111101010111011111110101
1010100010101010001000000010101
1010101010111010101011101110111
1010101000101000101000101010001
1010101111101110111010101010111
1010100000100000001010101000001
1111101110101011101011111011101
1000001000101010001010000010101
1110111111101011101011111010111
1000100010001000101000001000001
1110101111101011101110111011111
1000000000101010000010100000001
1111111111111111111111111111111
