1111111111111111111111111111111
1000000010000010000000000000101
1011101011101011111010111110101
1010001000001000001010001010101
1110111111111111101011101010101
1000100000000010001000101000001
1011111110111110111011101111101
1000000010100010001010001000101
1111111010101011101010111110111
1000000010101000101010000010001
1011111110101110101111101111101
1000001000101010100000001000101
1011101010101010101111111010101
1000101010100010001000100010001
1110101011111011111010101111111
1000101010000010001010100010001
1011101010111111101010111010101
1010001000100010001010001010101
1010111110101010111010111011101
1010100010001010100010000010001
1110101011111010101111111110111
1000101010000010100010001000001
1011101011111010111010111011101
1000101000001000001010001000101
1110101111101111101010101110101
1000101000100010101010100000101
1011101110111010101011111011101
1000100010001010001010001000101
1010111011101011111010101111101
1010000000001000000000100000001
1111111111111111111111111111111
