1111111111111111111111111111111
1000000010000010001000001010001
1010111111101010111011111010111
1010001000101010101000101010001
1110111110101110101011101011101
1000100000100000001010101010001
1110111011101111111010101011101
1000000010100000100010100000101
1010111110101111101110111010101
1010000000000000101000000010001
1011101010101111101111101010111
1010001010100000000000001010101
1111101110111010111011111011101
1000001000101010100010101000001
1011101010101111111110101111111
1010001010001000000010000000101
1011101111101011101111101111101
1010000010000000100000000000001
1011111110101011101011101111101
1000101000101000101010000010001
1011101010111011111110101111101
1010100010001010000010100000101
1010101110111011101011111011111
1000101000100000001000001000101
1011111011101011101110111011101
1010101010001000101010101000001
1110101010101011111011101011111
1010000010101000000000100000001
1010111011101110111011101110111
1000100010000010001010000010001
1111111111111111111111111111111
