1111111111111111111111111111111
1000001000000010000000001000001
1011111010111110101111111011101
1010000010001000100000100010001
1010111111101011111110101110111
1010001000001000001000101010001
1011101011101110111011101011101
1010001000100010100010001010001
1010111110111110101110111010111
1010100010000000100000000010001
1010111011111110111111111111101
1010100000100010001000000010001
1010101110101011111011111010101
1010001000101000000010001000101
1011111011101111101111101111101
1000100010100010001000100000101
1010101110111011111010111010101
1010101000001000000010001010001
1110101011101111111111101111101
1000101010001000100000100000101
1011101011101010101010111110111
1010001000100010101010100010001
1010111010111110111010101110101
1010100010001010000010001010101
1010101111101011111110111011101
1010101000001000100000100010001
1010101011111011101111101110111
1010101010001000100010100010001
1010111010101010111010111011101
1000000010100010000000001000001
1111111111111111111111111111111
