1111111111111111111111111111111
1000000010000000100010001000001
1010111010111010111011101011101
1010101000101010000010001000101
1010101111101011111110111110101
1010101000001000000000001000101
1010101011111111111011101011101
1010001000100000001000101010001
1011111110101010101110101110101
1000100010101010100000100010101
1110101010101110111111111010101
1010101000100010001000100000101
1010101111111011101010111111101
1010001000000010001010001000001
1010111011111110111111101011111
1010001000000010001000001010001
1011111111111011101010111011101
1010000010001010100010001000101
1010111010101010101111101110101
1010100000100010101000101000101
1010111111111110101110111011101
1010000010000000101000001000101
1011101011111110101111101110101
1000101000000010100000101000001
1010101111111010101110101011111
1010100010001010100010101010001
1110111010101010111010101010101
1000100010100010001010001010101
1011101010111111101011111011101
1000001010000000001000001000001
1111111111111111111111111111111
