1111111111111111111111111111111
1000101010000010000000000000001
1010101010101011101011101111101
1010000000101000001010001000001
1011111011101110111010111010101
1000001010000010001010001010101
1111111111111111101111111111111
1000001010100000000010100000001
1010101010111111101010111110111
1010101010101000001000100010001
1110111010101110101010111010111
1000000010001000101010100000001
1011101010101010101010111011101
1000101000100010101010000010001
1110111111111111111011111111111
1000001000101010101000101010101
1011101110101010101010101010101
1010001000100000100010000000001
1111101011111011101111111111111
1010001000100000100000001010001
1010111011101111111110111011101
1000001000100010101000001000001
1010111010101110101011101011111
1010001010100000100000101010001
1011111011101111101110101010101
1000001010100000101000100000101
1011111010111010111111101111101
1010001000100010000000101000101
1010111110111011101110101110101
1000001000000000100010001000001
1111111111111111111111111111111
