1111111111111111111111111111111
1000000010100010000000000010001
1010111010101010111111111010111
1010001000101010100010000010001
1011101011101010101010111110101
1010001010001010101000100010101
1010101111111010111110101011101
1010101000000010000010101000001
1110101011111110111010101111111
1000101000100010100010100000001
1011101110101010101110111110101
1010000010101000100010000010101
1011111010111111111011111011101
1000100010100000001010001010001
1010111010101111101010101010101
1010001010100010001010100000101
1111101010101011101011111111101
1000001010101000100010001000101
1011111010101110101110101010101
1000001010101010101000101010101
1011101110101010111011101011101
1010001000100010000000101000001
1010101011111111111111101011111
1010101010000000000000101010001
1010111010111111111110101011101
1010001010001000001000101000101
1111101011101010111011101110101
1000001010001010100010001000101
1011111010111010101111101011101
1000000000100010000000001000001
1111111111111111111111111111111
