1111111111111111111111111111111
1010000000001000001000000010001
1010111111101011101110111110101
1010000010100000100000100010101
1011111010111110111110101010101
1000000010000000100010001000101
1011101110111111101011111111101
1010101000001000101000001000101
1010111011111010111111101010101
1010001010100010000000101010101
1111101010101111111011101011101
1000001010101000100010001000101
1011111010101110101110101110101
1000000000001000100000101010001
1111101111111011101111101011101
1000100000101000100000101000001
1110111110101110101110101111111
1000100000100010001000101000001
1011101111101011111011101011111
1000001000101010001010001010001
1111111010101010101010111010101
1000001010101000101010001000101
1011101010101111101111101011101
1010001010100010001000100010101
1010111010111010111010111110101
1010000010100010001010100000101
1011111010101111101110101011101
1000100010100000100000001010001
1110101111101110101111111010101
1000100000001000100000001000101
1111111111111111111111111111111
