1111111111111111111111111111111
1000000000000000000000000000001
1011111011101010101110101011111
1000100000101010101000101000001
1010111110111011111010111111101
1010100000100000100010100000001
1010101010101110111111111111101
1010101010101000000000000010001
1010111010101011111011101010101
1010100010101000100010001010101
1011101110101011101110111010111
1000101000101000100010001010001
1010101111101011111011101010111
1010100010001000001000101010001
1010111111111011111111101011101
1010001000000000000000101000101
1110111111101010111011111010101
1000100000001010001000001010101
1110111010111110101110111011101
1000001010100000100010001000101
1011111111101110101011101011101
1000001000001000101010001000101
1010101011101111111110101010101
1010101000100000000010101010101
1011101011101010111011101010101
1000101000101010001000101010101
1010101011101111111010101111111
1010101010001000000010100000001
1011101111101011101010101110101
1010000010001000101010100010101
1111111111111111111111111111111
