1111111111111111111111111111111
1010000010001010000010001010101
1010101111101011111010111010101
1000100000000000000000100010101
1010111111101111101110111010101
1010101010001000100010000000001
1011101010101110101110111111111
1000100000101000001000000000101
1010111010111111111011101111101
1010100010101000100010100000001
1011111011101011111010101011111
1000100010000000000000101000001
1011101011101110111011101011101
1010001010000010001000101000101
1111101110101111111010111011111
1000001000101010000010101000001
1010111111111010101111101110111
1010100000000000100010000000001
1011111011111011101111111010111
1000100000101010001000000010001
1011101110101111101111101011111
1010001000100010000000101000101
1111111111101110101111101110101
1000000000000000101000101010001
1011111110111010101011101010101
1000101000001010100010001000101
1011101110111110101011101011101
1010000000000010101000101010001
1110101011101010101110111010111
1000101000101010101000100010001
1111111111111111111111111111111
