1111111111111111111111111111111
1010100010100010101000100000001
1010101010101110101110101010111
1000101000100010100000001010001
1110101011101110101110101110101
1000001000000000000010100010101
1011111111111011101110101111101
1000100000000010001000100010101
1110111111111110101110111110111
1010100000100000101010000000101
1011111110101110101011101111101
1000000000001010100000100010001
1110101010101011101010111111101
1010101010101000001010000000101
1011101011111110111011101011101
1000001000000010001010001000001
1110111010101011111111111011111
1000101010101010100000000010101
1110101010101010101110101110101
1000100010101010101000101000101
1011111111101110111011111011101
1000101000101010101000100000001
1010101010101010101010101010111
1010000010101010000010101010001
1011111011111011111110111011111
1000001000001010000010000000101
1011101110101010111110111111101
1010001000100000100000000000101
1010111011101010111010101111101
1010001000101010100010100000001
1111111111111111111111111111111
