1111111111111111111111111111111
1000000000100000000010000000001
1011111010101011111011111110101
1000100010101000100000000000101
1011101110111110111111111111101
1010001010000010001000100000001
1110111011111011101010101111111
1000101010001000001010001000101
1011101010101111111011111010101
1010001000100000101010001010101
1010111110111010101010101010101
1010000010101010001000100010001
1011111010101011101111111111101
1000001010101000100000001000001
1111101010101110111111101011111
1000001010001010000010001010001
1011111011101011111010111010101
1010000010100010000010001000101
1010111110111010111111101111101
1010100000100010001000001000001
1010101111101111101111111011111
1000100000100000101000001010001
1111101110111011101011101011101
1000100010000010001000101000001
1110111011111110101110101111101
1000100010000010100010100000101
1010101110111010111110111110101
1010100010001010100010100000101
1011111011101010101010101111101
1000000000001010001000100000001
1111111111111111111111111111111
