1111111111111111111111111111111
1000100000001000001000000010001
1110101111101011101111111010101
1000101000101000100000000010101
1011101010101110101111111110111
1000001010000010100010000000001
1011111011111010111011111011101
1010001010000010100010001000101
1110101011111010101110101011101
1000101010001000100010101010001
1011101010101111101010101110101
1010001000100010101000100000101
1010111110111010101111111111111
1010100010001010000010000010001
1011101011111011111110111010101
1010001000001000001000100000101
1010111011101110111011111111101
1000100010100000100010000000101
1111101110111011101010111110101
1000101010001000101010001000101
1010101011101110101111101011111
1010100010001010100000001000001
1010111010101010111110111111101
1010100010100010000010100000101
1010111110111111111011101110101
1010100000000010001000101010001
1010101111111010101110101011111
1010001000001010100000100000001
1011111111101010101110111011101
1000000000001000100010000010001
1111111111111111111111111111111
