1111111111111111111111111111111
1000000000000000000000001000001
1110111111111110111111101011101
1000000000000010100000100010001
1011111011111011101110111111111
1000100010100010000010000000001
1111101110101110111111111111101
1000001000001000100000100000101
1011111111111011101110101011101
1010100010000010001000101000001
1010101010111110101110101111111
1000101010100000100010001000001
1110101010101111111011111011101
1010101000100000001000100010101
1010101111111111111110101110101
1010101000001000000000100000101
1010101011111011111110111110101
1000100010000010001000100000101
1011111110101110101011111111101
1010000000101000100010000000001
1011101111101011111110111110111
1000001000001000000010001000001
1111111011111111101111101011111
1000100010000000100010001010001
1010101010111110111011101011101
1010101010100000100000001000001
1110101010101110111111111111111
1000001010100010100000000000101
1011111011111010101111111010101
1000001000000010001000000010001
1111111111111111111111111111111
