1111111111111111111111111111111
1000001000100000100000100000001
1110101110101110101111101111101
1000100000101010100000001010001
1011111111101010111011111010101
1010000000101010000010000010101
1010111010101011111110101110101
1010100010100000100010101000101
1010101110111110101011101011101
1000100010000010001000001010101
1111111011111011111111111010101
1000100010001000001000000010101
1110101111101111101110111110101
1000000000101000001000100010001
1011111110101011111010101110111
1000100010001000100010100010001
1111101011101111101111101011101
1000001000000010001000001000001
1011111111111110111011111011111
1010000000100000100010001010001
1010111111111111111011101010111
1010000010000010000010001010001
1010111010111010101110111011101
1010001010100010100000100000101
1011111010101110111111111110101
1000001000100000100000000010001
1111101010111111101011111110111
1000001010001000101000100010001
1011101111101011101110101011101
1000100000001000000010001000001
1111111111111111111111111111111
