1111111111111111111111111111111
1010100010001010100010100000001
1010101010101010101110111011111
1000001000100010000010000000001
1111101111111010111010101010111
1000000010000010100010101010001
1110101110101110111110101110111
1010100010100010000010100010001
1010101010111011101011111111101
1000101010100010001010101010001
1110111111111110111110101010101
1000101010101000001000001000101
1011101010101011101010111011111
1000101000000010001010000000001
1110101111101111101010111010101
1010100000101010000010001010101
1010101010101011111111111111101
1000001010000010100000000010001
1011101111111110101011101110101
1000100010001010001000100000101
1110101110111011111111111011111
1000100010000010100010000000101
1110111010101010111011101111101
1000100000101010000000000000101
1111111110111111111011111011101
1010000000100010000010000010001
1010101010111010111111101110101
1000101010000010001010000000101
1111111011111111101010101110101
1000000000000010000010100010101
1111111111111111111111111111111
