1111111111111111111111111111111
1000000000000000000000000000001
1010101111111011101010101011101
1010100010000000101010101010001
1011101110111010111010101110111
1010001000100010001010100010001
1011111111111110111010111111101
1000000000000010100010000000101
1010101111101110101011111010111
1010101000000010101000001010001
1010111011111010101010101010111
1010100000100010101010101010001
1010111010101110101111101010111
1010001010101000100010001010001
1010101011101110101011101011101
1010101000101000101010001000101
1111111011111111111111101110101
1000000000000000000010001000101
1010111011111010101011111110101
1010100010000010101000001000101
1011101111101010101011111011101
1000101000001010101000001010001
1011101011101010111110101010101
1000101000101010001000101010101
1110101110101111101111111111111
1000101000101000000000000000001
1010101110111111111111101111101
1010101000000000100000000000101
1011111111101110111011111010101
1010000000001000100000001010101
1111111111111111111111111111111
