1111111111111111111111111111111
1000101000001000100000000010101
1010101010101010101010101010101
1010000010100010001010101000001
1111111111111011111111111111111
1010101000100000001000001000001
1010101011111011111111101110111
1000000000101010101000001000001
1111111011101010101010111110111
1000001000000000001010000010001
1011101110111011111010111010101
1010000000100010000010001000101
1011111110111010111011111111101
1010000010100010101000001000001
1010111010111010101110111110111
1010100000100000001000001000001
1111111111111111111111101110111
1000001000100010100000001010001
1110111010101110111110111010101
1010001010000000100010001010101
1011101111111110101111101011101
1000001010101000100000001000001
1111101010101010101111101110111
1000000010100010100010001000001
1111101010101111101110111110111
1010101000000000100010001000001
1010101110111111111111101011101
1000001010000000000010101010101
1110111011101010101010101010101
1000001000001010101000001000101
1111111111111111111111111111111
