1111111111111111111111111111111
1000000010000010000010000000101
1110111010111011101011111010101
1000100010001000001000000010001
1011111011101111111111111111101
1000001000001000100000000000001
1011101011111010101111111111111
1010001010000010100000001010001
1110111010111110111111101010101
1000101010001010100000101000101
1011101011101010111010101011101
1010000000101010001010001010001
1011111111101011101011111110111
1000000000000010001000000010001
1011111111111110111111111011101
1000000000100000100010001000101
1111111110101111101011101110101
1000000000100000001000100000001
1011111110111111111110111111101
1010000010000010000010000010101
1010111011111110111010111010101
1010001000000010100010101010001
1011101111111010101110101010111
1000101000101000100010001010001
1111101010101111111011101011111
1000101010001000001010001000001
1010101011101011101011111011101
1010001000101000101000001000101
1011111010111110101111101111101
1000001010000000100000000000001
1111111111111111111111111111111
