1111111111111111111111111111111
1000100000100010101000000010101
1011111011111010101111101010101
1010001010000000001000001010001
1011101011111011111110111110111
1010101000000000100010001010001
1010101010111110101010111010111
1000001010101000001000000010001
1010101010101110101111101111101
1010101010001000100010100010001
1110101110111010111010101011101
1000100010001010100010001010001
1110101110111110101110111011101
1000100010000010100010100000001
1011101111101111111011111011111
1000100000101000001010000010001
1011101111101011101010101110101
1010000000000000101010100000101
1111101111111010111110101010101
1000000010001010001000101010101
1010111111101110111011101111101
1010000010100000101010101010001
1011111110101110101110111011101
1000100000000010100000101000001
1011101010101111101010101010111
1010001010101010101010100010101
1011101111111010111010101111101
1010000010000000001010001000001
1110101011111110101110111011101
1000101000100000100000000000101
1111111111111111111111111111111
