1111111111111111111111111111111
1000101010101010000010000010001
1011101010101010101110101111101
1000000000000010101000100010001
1010101011111010111111101110101
1010101010001010101000001000101
1110111111101010101011111011111
1000001000000010101010100000101
1011111011101010101010101111101
1000100000101000001000100010001
1010101111101011111010111011101
1010101010001010001010000000001
1111101011101011101010101010111
1000001010101000000010101010001
1111101010101111111111111110111
1010001000000010001010000000101
1010111110111010111010101011101
1000100010100000100010101000001
1011101110101110101011111111101
1000000010101000101000001000001
1111111010101110111110101010111
1000000010101000100010100010001
1111101011101110111010111011101
1010001010101000100010101010001
1010111110111110111010101011111
1000101000100010100010001000001
1010101011101110111010111110111
1010100000100000100000100010001
1110111011111110111010111011101
1000001000000000001010000000101
1111111111111111111111111111111
