1111111111111111111111111111111
1000001000100000001010000000001
1110111011101010111010101010111
1010001000001010000000101010001
1011101110111111101110111111111
1010001000000010101010100010101
1011101110111010101010101010101
1000001010101010001010001010101
1110111010101011101010111110101
1000001000001010001000001010101
1011111111101111111010111010101
1000001000000000001010000000001
1110111110101110101110111111111
1000001000101000101010001000001
1110101011111110101010101010101
1000101000001000101000100010101
1110111010101110101011111111101
1000000010101000101000001010101
1011111111111111111111101010101
1010001000000000001010000000101
1010111011101011101010111010101
1000000000101010001000001010101
1111101110101010111111111110111
1000101000101010001000000010001
1110101011101011111010101111101
1000001010101000001010100010001
1011111010101111111110101111101
1000001000100000001000100000001
1110111111111111111111111111111
1000000000000000000000000000001
1111111111111111111111111111111
