1111111111111111111111111111111
1000000000000010000000000000101
1010111111111011101110111110101
1010101000001000100010100010101
1010101010111110111110111010101
1010100010000010000000100010001
1010101111111011111111101111101
1010101010001000000010000000101
1010101010101111101110111110101
1010101000100000100000100010101
1010101111101111111111111010101
1010100000100000000000000010101
1110111110111011101111111010101
1000100010001010001000001010001
1011101011101110101011101011111
1000001010100000101010001000001
1011111010111111101010111011111
1010001010000000001010001010001
1010101011111110111011101110101
1000101000000010100000100000101
1111101111111011101111101111101
1000101000001000001010101000101
1010101011101111111010111010101
1010001000100000001010100010001
1011111010111111101010101111111
1010000010100000100010001010001
1011111110111110111011111010101
1010001000100000001010000000101
1010101011101111111011111111101
1000100010000000000000000000001
1111111111111111111111111111111
