1111111111111111111111111111111
1000000000001010001010101000001
1011111110101010101010101111101
1010100010101010100000001000001
1010101010101010111011101110101
1010001010101010100010001000101
1011111010101010111110111110111
1010000000101010100000001000001
1010111111101010111111101010101
1010000000100010100010101010101
1111111110111110111010101111101
1000001010000000100010001000001
1010101010101010111010111111101
1010100000101010100000001000001
1111111111111110111111101110111
1010001010101000101000001010001
1010101010101110101011101010101
1000100010001000100010001000101
1011101010111011111011111111101
1000101000000000100000001000001
1111111110111111111111111010101
1000000010100010001010001010101
1011111010101110101011101110111
1000100000000000101010001000001
1011101110101111111011101011101
1000100010100000001000000000101
1110111010101010101010111111101
1000101010101010101010001000001
1110101010101111111011101011111
1000100010100000000010001000001
1111111111111111111111111111111
