1111111111111111111111111111111
1010100000100000001000100000001
1010111011111110111011101111111
1000101010100000100000000010001
1110101010111011101110111111101
1010000010000000101000001000001
1010101010101010101111111011111
1000101000101010001010001000001
1011101110101110111011101011101
1000100010101000000000000000101
1011111010111110111010111111111
1000001010000010001010000010101
1011111011111110111110111010101
1000001000001010000010100000001
1010101011111011111111111011111
1010101000000010101010000000001
1011101110101110101011111011101
1000100010100000000000001010001
1010111111101110111010101011101
1010000000101000001010101010001
1011111010101111111111111010111
1010001010100000001000100010001
1010101110101011111010111010111
1000101000101000000010100010001
1011111110111010111011111110111
1000001000100010001000001010001
1010101111101010111011101010111
1010101010001010100010000010001
1011101011111011111111101110111
1000100000001000000010000010001
1111111111111111111111111111111
