1111111111111111111111111111111
1010000010100010001000101010101
1011101110101110111011101010101
1000101000000000001010000010101
1011101111101010111011101110101
1000000000101010100010001010001
1111111011101111111011101011101
1000000000000000100000100010001
1010101110111011111011111011101
1010101000001010000010101000001
1011111110111111111010101010101
1010000010001010101010100010101
1111101011101010101010101110111
1000101000000000000000001000101
1011111010111111111011111010101
1000000010001000000010101010001
1010101010101111101110101110101
1010101010100010001000100000101
1010101110111111111110101011101
1010101010101010000000001010001
1010111010101011111011111111101
1010001000000000100000100000001
1111111110111011111110111111101
1000000000001010000000100000001
1011101110111011101110111011101
1010101010100000101000001010001
1110111010111111111010101011101
1000001010001000101010101000101
1111101010111011101110111010101
1000000000000000100000001010101
1111111111111111111111111111111
