1111111111111111111111111111111
1000000010001010100000000010001
1111111011101010111011111010111
1000101000000000001000101000101
1110101110101110101110101111101
1010100010100010100010000000001
1010101110101011111111101010111
1010101000101010101010101010101
1010101010111110101010101111101
1000000010000000100000000000001
1011111011111111101010101111111
1000001010000010001010100000001
1111101010111010111110111111111
1000001010100010000010100000001
1111111010111010111010111110111
1010001000001000001010001000101
1010111110101111111110101110101
1000001000100000100000100010001
1010111111111110101110111111101
1010000000001000101010000000101
1010111011111011111010111110101
1010001000101000001000001000001
1011101110101010111111101011111
1010001000100010101000101000101
1010101111101110101010101111101
1010101000101000100010001000001
1011101010101011101111101010101
1000100010001000101000000010101
1011101011101011101110101111111
1010001000101010000010100000001
1111111111111111111111111111111
