1111111111111111111111111111111
1000100000101010100010001000001
1011101010101010101111101011101
1010001010001010001010000010001
1011101110111010101010111011101
1010000010000010101010100010001
1010111110111010101011111111101
1010100000101010100010001000101
1011111011101111101111101110101
1000000000001010000000000000001
1110111011101011101111101011111
1010001000101000000010001010001
1010111010111011101111111110101
1010101010100000100000001000101
1011101010101110111110101010111
1010100010101000100010100010101
1010101010111011101011101011101
1000001010000000101000001000001
1111111011111011101111101111101
1010001010001010001000001000101
1010111010101010101011111011111
1010101010100010101000000010001
1010101111101111101111101011101
1000000000101010101000001000001
1011111111101010111110101111101
1000000010100000100010101010001
1011111110111011101110111011101
1010001010000010000000000010001
1011101010111010111110101111101
1000000000001010000010100010001
1111111111111111111111111111111
