1111111111111111111111111111111
1000100000100000001010100000101
1011111011111010111010101011101
1000100000101010100010001010101
1110111011101110111011101110101
1010001010000000100010101010001
1011101010111111111010101011101
1000100000101010000010000000101
1110101110101011101111111011101
1000101010001000001010000000001
1110111010101111101011111011111
1000001000101010001000000000101
1111101011111011101111101011101
1010001000100000000010001000001
1011101110101110101111111010111
1010101010000010101010101010101
1010101011101111111010101110101
1000001010001000101000000010001
1010101011101010101110111111101
1010100010000010100000101000101
1011101111111011111110101110101
1000101000100000100000101010001
1011101110111011111011101011101
1010000000000000001010101000001
1111101110111011111010101011111
1000001010101000100000000000001
1110111011101011111010111111101
1000100000000000100010100010001
1111111111101110111110101111101
1000000000001000000000000000101
1111111111111111111111111111111
