1111111111111111111111111111111
1000000000000000000000000000001
1011101010111110111111101011101
1000101010000010000010001000101
1110101011101010101111101110101
1000101010001010100000101000101
1011111011111111111010111010111
1000001000000000001010001010001
1110111110111111101111101110111
1000000010100000000010000010001
1010111110101010111110101111101
1010100000101010001000100010001
1111101011111110111010111111101
1000001000000010100010000010001
1110111011101010111011101110101
1000001000101010100000100010101
1010111010101011101111111010101
1010001010101000100000100010101
1011101011101110101110101010101
1010001000100010101000101010101
1011101111101110111010111111111
1010000000100010100010000000001
1011101010111010111110101011111
1010001010001010001000101000001
1010111111111010101110101111101
1010000000001010101000100000101
1011111010101110111111101111101
1000100010101000000000100010001
1011111011111110101110101110111
1010000000100000101000100010001
1111111111111111111111111111111
