1111111111111111111111111111111
1010000010001000000000001010001
1010101110111011111110111011101
1000100010001000100000001010001
1111101111101110111111101011101
1000100010001000100010101010001
1011101111101010101010101011101
1000100010001010101000101000001
1010101111101011111011101011101
1010000010000000100000000010001
1111101111101111111111111111111
1000001010100000100000000010001
1011101010111011101111111111101
1000100010100000100000001010101
1111101110101110111011111010101
1000101010001000101000001010001
1011101010101111101010111010111
1000100010100000100010000000001
1010101111111110111111101011101
1010100010100000100000001010001
1011111010101110101011101010111
1000000000001000001010001010001
1111111111111111111111111110111
1000100010101010001010101000001
1110101110101010111010101111101
1000000000100010000010001000001
1010111011101010101010101010111
1010100000101000101000101010001
1011101011101010111110101010111
1000101000001010000010100010001
1111111111111111111111111111111
