1111111111111111111111111111111
1000100000001010000010100000001
1011101111111011111010101110111
1010000010001010000010001000001
1011111010101010101111101111111
1000100010100000100000100000001
1110101010101111111111111010101
1000101000101000000010000010101
1110101111101011101010111111111
1000100010101000101000101000001
1011111010111011111011101110101
1000101000001000100010000000101
1010101011111110111110111110101
1010000000000010000000101010101
1011101111101111111111101010101
1000101000100010100010000010101
1011101010111110111011101010101
1000100010000010000010101010101
1111111010111011111010101110111
1010001010100000000000001000001
1011101111111110101110101010111
1000001000101000101000100010101
1011101011101110111011111111101
1000100010101000100000000000001
1011101110101110101110111110111
1010000000100000100010100000001
1110111111111011111011111010101
1010001010000010000010001010101
1010101011101111101111101011101
1000100000000010000000100000101
1111111111111111111111111111111
