1111111111111111111111111111111
1000100000001010000010000010001
1110101111101010111010111110101
1000001000100010100010100000101
1011111011101110101110101111101
1010001000001000100010001000101
1011101111101011111010111011101
1000101000101010001010000010001
1110101010101010101111101110111
1000100010100010100000100010101
1011101110111110111110111010101
1000001000100010001010001010001
1111111011101011101010101010101
1000001000101000101010101010101
1010111110101110101011101011101
1010000000101000001000001000101
1111111011101111111111111110111
1000000010000010000000001000001
1011111111111010111111101011101
1000000010000010100010001000101
1111101010111110101010111110101
1000001010001000101010000010101
1011111111101111101011101011101
1000000010001000001010001000001
1111111010101011101110111111111
1000000000101000100000100000001
1010101111111110101111111011101
1010100000100010101000001010101
1011111110101010101110101010101
1000000010001000100000100010001
1111111111111111111111111111111
