1111111111111111111111111111111
1010000000000000001010001000001
1010111110111011111010111110111
1000000010100010100000000000101
1010101111101110111011111011101
1010100010000000000010001000101
1011111111101111101010111111101
1010100000101000001010001000001
1110101110101011111110111011111
1010001000001000100010001010001
1010101111111111111010101010101
1000100010100010100000101000101
1110101110101010111011111011111
1000100000101000001010000000101
1110111011101111101010101111101
1000101000100000100010100000101
1011101110111111101111101111101
1010000000101000100000100010101
1110101011101110101111101010101
1010101000100010100010101010001
1010111010101110101110101110111
1000100010101010000000100000001
1010101110101011111011101011101
1010101010001000001010101010001
1010101010101010101010101011101
1010100010100010100000001010001
1110111111111111111111111011101
1000000000001000100000000010101
1011101011101011111110111110101
1010001000101000000000100000001
1111111111111111111111111111111
