1111111111111111111111111111111
1000000000000000000000000000001
1010101110111110101111111110111
1010101000100000101000000000001
1011101110111010101111101010101
1010001000001010101000001010101
1110101010111011101011101110111
1000101010001010001000100010001
1111111010111010111110111011101
1000000010001010000010100000101
1111111011101011111110111011111
1000000000101000000010100000001
1010101010101010101010101111101
1010101010101010101010101000001
1110101110101010101011111011111
1000100010101010101000100000001
1010111011101011101010101110111
1010001000101010001010100010001
1010111011111010111110101110111
1010100010000010000010100010001
1111111011101110101110111011111
1000000010001000100010100000001
1110101111101111101011111111101
1000100010001000001010000000001
1011101010111011101011101110101
1000101010100000101010000010101
1010101010101111111011101011101
1010101010101000000010001010001
1111111110101110101010111110111
1000000000101000101010001000001
1111111111111111111111111111111
