1111111111111111111111111111111
1010000000000010000000100010001
1011101111101011101111101011101
1000100000101000101010101000001
1110101011101111101010111110101
1010101010100000000000101000101
1010111110101111101011101110101
1000000010001000001010001010101
1010111110111111101010101010101
1010000010001010101010101000101
1011101011101010101010111111101
1010101000100010001010001000101
1010111010111011111110101110101
1010101010000000001010100010001
1010101011101011111011111010111
1010100010001000101000000000001
1110101111111011101011101111101
1000100010001010100010000010101
1011111111101010111111111010111
1010100010001000001000100000101
1010101010111011111110111010101
1010101010101010000010000010001
1010101110101011101110111011101
1000001010000000001000001010001
1010101010101011101010111011101
1010100010101010000010100000101
1011101110111011111010101111101
1000100000100000100010101000101
1111101110111010111110101110101
1000001000001010100000100010001
1111111111111111111111111111111
