1111111111111111111111111111111
1000000000101000000000100010001
1011101110101010111110111010101
1000101010001010000010000010101
1011101010111011111011111110101
1010001000100010000010000000101
1010111011101110101110111111101
1010001000100010101000100000101
1011101110111010111011111010101
1000101000100010001000000010101
1111101011101111101011111111101
1000001010001010001010000000101
1011111010111010111010111110101
1000001010000010000010100000001
1011101111111011111110111111111
1010100010000010000010000000001
1010111010111110111011111111101
1000100010100000101010000010001
1110101110111011101010111110111
1010100010001000100000100010001
1010111011101110111111101011101
1010101000000000100010001010001
1010101111111111101010111010101
1010100000100000101010001000101
1010111110101110101010101111101
1010000010101000001010100010001
1011111010101111111011111010111
1000001010101000100000000010101
1010111010101010111111111110101
1010000000100010000010000000001
1111111111111111111111111111111
