1111111111111111111111111111111
1000000000100000001000001000001
1111111010111011101111101110111
1000000010101010001000000000001
1110111011101110101011111111101
1000101010000000101000100000101
1011101010111111101011101010101
1010100000001000100000001010101
1010111110111010111110111111101
1010001000100010101000101010001
1011101011111010101111101010111
1000001010100010101000000010001
1111101110111010101011101011101
1010000000001010100010001000001
1010111110111011101110101110111
1010100000001010101010100010001
1010111011101010101011111110101
1000100000101000100010100010101
1010111011111011101110111010111
1010101000100000001010001010001
1011101111101011101010101010111
1000001000101010000010100010001
1010111110111011111110101110101
1010101000001010000010101000101
1010101111101111101110101110101
1010001010001000000000101000101
1011101011101111101010111011111
1000101000100000101010000000001
1011111011101111111011111010101
1000100000000000000000001010101
1111111111111111111111111111111
