1111111111111111111111111111111
1000000000001000001000001000001
1011101111101011111011101110111
1010001010000000001010100000001
1010111011101111101010101111111
1010100000001000001010000000101
1111101111111010101011101111101
1010001000100010101010100010001
1010101011101111111010101111101
1000100010000000001010000000001
1011111111111111101110101111111
1010101000001010001010100000001
1010101110111011101010111111101
1000001010101010101000101010101
1111111010101010101011101010101
1000100010000000000000000010101
1010111011101011101111101010111
1010000000001010100010101000001
1110111010111110101010101110111
1000001010100000101000101000101
1010101011111010111111101111101
1010101010101010100010101000101
1110111010101010111010101011101
1000001000000010100000101010001
1010101010101111101111101011101
1010101010100010100000000010001
1111111111101110111111111010101
1000000000000000000010100000101
1111111011111010101010111110101
1000000010000010101000001000101
1111111111111111111111111111111
