1111111111111111111111111111111
1000001000000000000010000000001
1111101110111010101011111011111
1010101000100010101000101010101
1010101111101011111011101010101
1010001000101010000000100000001
1011101011111111111010111110111
1000000000000000100010001000001
1111111011111011101010101110111
1000000010001000101010100000001
1110101110111110111111101010111
1010101000001000001000001010001
1011111110111011101011111011101
1000000000000010000000001010001
1011101111101011101010111110111
1000101010001010001010100000101
1110111010101011111010111010101
1000001000101000100010100010001
1110111111101110111010111110111
1000100000100010100010100000001
1111101110101011111010101111101
1000000010001010000010100010001
1111111111101110111010101011111
1000001010000010100010101000001
1111101011101110111011111010111
1000000000001000001010000010001
1111111011101010111010101011101
1010100010001010100010101000101
1010101110101111111110111011111
1000001000101000000000100000001
1111111111111111111111111111111
