1111111111111111111111111111111
1000000000000000000000000000001
1110101111101011111010101011111
1000100010001000001010101000001
1011101110101010101011101111101
1010000010101010101000101000001
1110101110101010111110101111101
1000100010101010001000101000001
1110111110101110101010111111111
1000000010101000101010000000001
1111101011111011101110111110101
1000001000001000101000000010101
1011101010111010101010101111101
1000101010001010101010100000101
1110111011101010101010111110101
1000001010001010101010000010101
1011101111101110101011101011101
1010001000000010101010001010001
1011101011111010111010111110111
1000101000001010100010100000001
1110101010101110101010111011101
1000101010100010101010100010001
1110111111111111101111111011111
1000000000001000000000001000001
1110111111111110111110101010111
1000000010000000100000101010001
1010101011111011111111101110101
1010101010000000000010000010101
1010101010111011101010111011101
1010101010100000101010100000101
1111111111111111111111111111111
