1111111111111111111111111111111
1000100000100010001000001000101
1010101110101010111011101010101
1010001010001010000010000010001
1011111010111111101110111111101
1000100010001000101010001010001
1110101111101010101011101010101
1000100000100010001000101000101
1011111110111111111110101111111
1000001000100000000010001000001
1111101010111011111011111110101
1000101010000010100010000000101
1010101011111110101110111011101
1010000010100010001000101000101
1011111010101010111110101110101
1000101010001000100000100000101
1110101011111111101111111110101
1010101000100000001000001000101
1010101010101110111111101011101
1000101010100010001000100000101
1111101011111011101010111110101
1000001000001010001010000010101
1111101111101110111011111011101
1000100000100000101000100010001
1010101110111111101011101110111
1010001010100000001010001000101
1011111010101011111010111011101
1010000010001000000010000010001
1011101011111111111011111111101
1000001000000000001000000000001
1111111111111111111111111111111
