1111111111111111111111111111111
1010000010101000100000100000101
1011101110101110111110111011101
1010001000001010000010000010001
1010101010111010111010111110101
1010100010101000100000001000101
1010101110101110111010101011101
1000101010101000100010101010001
1011111010101110111011111110101
1010101000000010001010101000101
1010101011111010111110101111101
1000001010101000001000000010001
1010111110101111111110111110111
1010100000000010001000000000001
1011111111101010101011111011111
1010001000101000100000101000001
1011101110101111111010101011101
1000000000000000100010100010101
1111101111111110101011101010101
1000001010000010101010101000101
1111101010101111101110101111111
1000001000101000001000001010001
1010111110111111111110101010111
1010000010000000001010100000001
1110111110101111111011101110101
1000000000100000001000100010101
1110111010111110111011111110101
1000100010101000100010000000101
1011101011101110101011111110101
1000101000001000001000100000101
1111111111111111111111111111111
