1111111111111111111111111111111
1000001010000010100010000000001
1011101010101010101011111111101
1010000010101000101010000000001
1011111010101111101010111111101
1000101010100000001010000010101
1110101010111111111011101010101
1000100010100000001000101010001
1011101110101011111110111010111
1000101000101000001000100010001
1110111011111111101011101111111
1000100010001000001010000000001
1011101110101011111010111111101
1010001000100010000010101000001
1010111110111010111110101011111
1010000000100010100010001010001
1011111111101110101111101010101
1010000000100010001000001000101
1010111110111011111110111111101
1010001010000010000010100000101
1011101011111110111010111011101
1000101000000000101010000010001
1110101111111010101011111010111
1000100010001010100010000010001
1011111010101110101111111011101
1000100010100010101000001010001
1110101110111010101011101010101
1000100010101010100010001010101
1011111010101010111110111110101
1000000000100000100000000000101
1111111111111111111111111111111
