1111111111111111111111111111111
1000000000001000000000100000001
1010111111111011111110111111101
1010100000001010001000100010001
1011101111101010101111101010101
1000100010101000101000001000101
1010111010101111101110101111101
1010000010100010100010101000001
1011111110101010111011101111111
1000000010101000101000100000001
1111111010101110101110111111101
1010000000100010100010001000001
1010111111111010111011101011101
1010001000100010000000100010001
1011101010101111111111111110111
1010001010100000000010000000101
1010111010111111111010111111101
1000100010000000100010100000001
1011101111111110101110111011101
1000100000100000100010000010101
1110111110101111111011111110101
1010100010100010000000001000001
1010111010111010111111101011111
1010001010001010000010001010001
1011101011101011111011111010111
1010001000101000001010000010001
1010111110101111101010111111101
1000100000100000100010001000001
1011111010111110111111101110101
1000000010000010000000000000101
1111111111111111111111111111111
