1111111111111111111111111111111
1000001010001010101000100010101
1011101010101010101110111010101
1000100000100000100000000000001
1011111011111110101111111010111
1010000010001000101000001010001
1010101010101110101010111011111
1010101000100010001010000010101
1010111011111011111110111110101
1010001000001010101000000000001
1111111011111110101110101111111
1010000000000010100010100010001
1011101011111110101110111011101
1000001010000000000010001000101
1111101011101111101111111110101
1000101000000010100010101010101
1110101110101110101010101010101
1010001000101000101010000000001
1011111011111110111111111111101
1010101000000000001010001000101
1010101111101111101010111110101
1000100000101000000010001000001
1110101110101110101010111110101
1000001010101010101000001000101
1111111010101010101011111110111
1000000010100010101000100010001
1010101010101111111011111010101
1010101000000000101000100000101
1011101111101111101010111011101
1000101000000000001010100000101
1111111111111111111111111111111
