1111111111111111111111111111111
1000000000100010000010001000001
1011111110101110111010101110101
1000100010001000101000100010101
1010101011111111101111111011101
1010001000100000100000101000001
1011111110101010101010101111101
1010000010001010101010101000001
1010101111111010111010101011111
1010100000001010100010001010001
1011111011111010101111101010101
1000001010001010001000101010101
1111101010101011111010101010101
1000101000101000100010001000101
1011101111101110111110111111101
1000101000001010000010001000101
1010101011101011111011101010101
1010001010100000001010001010001
1011111010111110111010111011111
1000100010100010100010001010001
1110101110101010101111111010101
1010001010001010101000000010101
1011111010111010101011111110101
1010000010101010101000001000101
1010101110101010101111101010101
1000100010101000100000101010101
1011111010101111101111101110101
1000101010000010100000100000101
1110101011111010111110111111101
1000001000000000000010000000001
1111111111111111111111111111111
