1111111111111111111111111111111
1000000000000000000000000000001
1011101110111011111011111010101
1010000010100000100000100010101
1011111110101011101011101011101
1000000010101010001000101010001
1011101111111010101010101111101
1010000000001010101010100010001
1010111010101110101011111010101
1010001010101000101000001010101
1010111011111010111010101110101
1010001010000010100010100010101
1110101111111111111110111110101
1000100000000000001000000010101
1011101111101011111110111011111
1010000000101000000010100000001
1110111011111110101110101010111
1000100000100000100010101010001
1011101011101111111011101111101
1010001000100010000010001000001
1011111110101010101110111010101
1000100000101010101000001010101
1011101111111110101010111110111
1010000000001000101010001000001
1111101010101010101110111111111
1000001010101010100010000000001
1110111110101111111111111010101
1000000010100000001000000010101
1010101111101010111111111010111
1010100000101010100000000010001
1111111111111111111111111111111
