1111111111111111111111111111111
1010000000101010000000000000101
1010111111101010111011111111101
1000101000001010001010100000101
1010101111101010111110111011101
1010000010100000001010100000101
1110111110101111111010111011101
1010000000101010000000100010001
1011111011101010111111101110111
1010000000001000001010000010001
1011111011111110111010111110111
1000101000000000000010100000001
1011101011111111111110101111111
1000000010100010100000001000001
1110111010101010111010111010101
1000001000001000000010000010101
1010101110101111101110111111101
1010101000100000100010001010101
1010111011101111101111101010111
1010001010101000000000100000001
1010111010101111101111111011111
1010001000101000001000101000101
1110101110111011101011101011101
1010101000001010000000001010001
1010101110101110101111111010101
1000101000100010100000100000101
1010111111101111101110111110101
1010001010100000100010101000101
1011111010101110111011101111101
1000100000000010100000000000101
1111111111111111111111111111111
