1111111111111111111111111111111
1000000000000000000000000000001
1010101110101110111011111110101
1010101000101000001000001000101
1110101010101010101111101111101
1000101010101010101000000010001
1010101110101011101111111011101
1010101000101010000010000010001
1111101111111011111011101110101
1000001000000010000010001000101
1011101110101110111010101011111
1000100010100010100010101000001
1011101010111011101010111111101
1000101010100010001010100000001
1011101111111010101010111110101
1010001000000010101010001000101
1010111010111010111110111111111
1010001010100010100000000000001
1110111011111110101010101011101
1000001010000000101010101010001
1110101110111110101110101110111
1000100010001000100010100010001
1010111010101010101111101110111
1010100010101010100010001000001
1011101010111011101010101110101
1000101010001010001010101000101
1010101110101010101011111110101
1010101000101010101000001000101
1011101010101011111010101011111
1000101010101010000010101000001
1111111111111111111111111111111
