1111111111111111111111111111111
1010001010000000100010001000001
1010101010111110111010111011101
1010100010100000001010001000101
1010111010101111101011101011101
1000001000100000101000000010001
1011111110111110101111101110111
1010000010001000100000001010001
1110111011101111111111111011101
1000100010001000001010001000101
1011101110101011101010111010101
1000101000100010001010001010001
1110101011111110111011101011111
1000100010100000000000101010001
1111111110101111111111101010101
1000000000100000100000101000101
1011111110111110101110101111101
1000001000100000000010001000001
1111111011101111111111101011111
1010001000100000100010001000001
1010111110111111101011101111101
1010000000100000001000101000001
1011101111101111111010111010111
1000101000000010000010000010101
1110101110111110111111111110101
1000100000100010000000001000101
1011111111111011111111101011101
1000000010001000100000101000101
1111111010101010101010111110101
1000000000100010001010000000001
1111111111111111111111111111111
