1111111111111111111111111111111
1000000000000000000000000000001
1110101110111010101110111010111
1000101000100010100010001010001
1010101011101010111011111010101
1010101010001010001000001010101
1111111011101011101010111111101
1000000010001000101010100000001
1011101111111011111010101010101
1000100000001010000010101010101
1011101110101011101011111110101
1010001000101010001010000000101
1110111010111110101010111011101
1000100010100000101010100010001
1110111011111110101010101010111
1000100010000000101010101010001
1110101010101111111111101010101
1000101010100000001000001010101
1011101111111111111011101011111
1010000000001000000000101000001
1011111011111111111111101010101
1000001000000000001000001010101
1110101111101011101111101110101
1000100000101000100010000010101
1010111011101110111111101011101
1010001000101000001000001010001
1010111010111010111011111110111
1010100010100010001010000000001
1010101011111110111011101111101
1010101000100000001010001000001
1111111111111111111111111111111
