111111111111111111111
100000000000000010001
101110111111111010101
101010100000101010101
101010101110101011101
100010001000100000001
111011111011111111111
100010001000000010001
101110101111111010101
100000101000001000101
111111101010111110101
101000101010100010101
101010101110101011101
101010000010101000001
101011111010101111111
101000101000101000001
101110101111101111101
100000100000001000101
101111111111111010101
100000000000000010001
111111111111111111111
