111111111111111111111
101010001000000010001
101010101110111010111
100000101000100000001
101111111010101111101
100000001010100010101
101010101110111010101
101010101000100010001
101111111011111111101
100000101000000010001
101010101111111011101
101010000000000010001
111111101111111110111
100010100000100010001
111010111011111011101
100010000000100010001
111010101111101110111
100010100000100010001
111010101110111010111
100000101000000010001
111111111111111111111
