111111111111111111111
101000000000000000001
101011111011111111101
101010001000101000101
101011101110101011101
101000100010000010001
101110111011111110101
101000100010001000101
101010101110101011111
100010001000101000001
111111111011101111101
100000001000101000101
101110101110101010101
100010101000100010001
111110101011111111111
100000101010001000001
101111101010101011111
101000101000100010001
101010101011101011101
100010100010001000001
111111111111111111111
