111111111111111111111
100000000000000000001
101011111110101111101
101000100000101000001
101111111111101110111
100000100000001000001
101011101111111010101
101000101000000010101
101111101011101110101
101000001010001000101
101110101111101111101
100010100010001000001
101111101010111011101
100010001010100000101
101111111010111010101
100000100010100010101
101011101011101010101
101000101000101010101
101110111011101111111
101000001000100000001
111111111111111111111
