111111111111111111111
101010000010100010001
101010111110111010111
100000000010000010101
111110111111101110101
101000000000101010001
101111101111101010101
101000101000000000101
101110101111101111111
101010001010000010001
101011101011101110111
100000101000100000101
111011101110101111101
100000000000101000001
111010111110101010101
101010101000000010101
101010101011101111111
100010100010000000001
111111101111111010111
100000001000000010001
111111111111111111111
