111111111111111111111
100000000000000010001
101011111111111010101
101000001000101000101
101111101010101111101
100000100010100000101
111110111110101011101
100010001000101000001
101111101011101111111
101000101010001000001
101010101011101110101
100010001000100010101
101111111110111010101
100010000000101000101
111110111110101111101
100010100000100000101
101010111111111110101
101000100010000010101
101111101010101110101
100000001000100000101
111111111111111111111
