111111111111111111111
100010000000000000001
101010111111111111101
101010001000100000001
101111101110101111101
100000001000101010001
111011111011101010111
100010000000100010101
101111101111101010101
100010001010001010001
111010111010111111111
101010001000000000001
101010111111111110111
100010100000000010001
111010101111111011101
101010001000001000001
101010111011111011111
100010001000000010001
111111101111111110101
100000000000000000101
111111111111111111111
