111111111111111111111
100000000010000010001
111111101011111010101
100000101000000010101
101110101110111111101
101010100010000000101
101010101011111111101
101000101000100000001
101111101110101111111
100010001000101000001
111010111011101011101
101010001010001010001
101011101110111110101
100010001000100000101
101010101011101111101
101000101000100010101
101111101110111010101
101000100010001000101
101010111011101110101
100010001000000000101
111111111111111111111
