111111111111111111111
100000001000101010001
111110111010101010101
100010001010001010101
101110111010111010111
100000001010000000001
111011111111111110111
101010001000100000001
101011101011111110111
100000001000001000001
111111101110101010111
100000001000100010001
111111101011101111101
101010001000100010001
101010101011111011111
101000101000100000001
101011111111101111111
101000000010001000001
101110101010101010101
100000101000100010101
111111111111111111111
