111111111111111111111
100000001000001000101
101111101111101010101
101000000010101010101
111011111010101110101
100010001010000000101
101110111010111111101
100010100010000010001
111010101111101010101
100000101010001010101
101111101010111110101
101000000010001000101
101111111011101011101
100000101000101010001
111110101110101010111
100000100000101010001
101111111111101011101
100000000000001010101
111110101111111010101
100000100000000010001
111111111111111111111
