111111111111111111111
100000100010000000001
101110101110101111111
100010100010100000101
101010101110111110101
101010000000100000001
111011101011101011101
100010101010001000101
111110111111101011111
101000100000101000101
101110101011111011101
100000101010101000101
111010101010101110101
101010001000000010001
101111111111101010111
100010101000001000001
101110101110111011101
101000001000100000101
101011101110111111101
100000100000000010001
111111111111111111111
