111111111111111111111
100000101000000000101
101110101011101011101
100010000000101010101
101110111110101010101
100010001000101000101
111111111111111011101
100000000010100010101
111111111010101010101
100000000010001000101
111111101111101110101
100010000010000010101
101010111010111111101
101010100010101010101
111011111010101010101
100000000000000000101
111011111011111011101
100010001010100010001
101010101010111010101
101010100010000000101
111111111111111111111
