111111111111111111111
100000100000001000001
101111101110101011111
100010001000100010001
111010111011111010101
100010100010001010101
101010101110111010101
101010101000000010101
101010101111111110101
101010100010000010101
101110111010111010111
100000100000100010001
111110101111101111101
101000100010101000001
101011111010101011111
100000001000100010001
111111111011111110101
100000000010001000101
101111111110101111101
100000000000100000001
111111111111111111111
