111111111111111111111
100010000000001000001
101010111111101011101
101010100000100000101
101110101110111111101
101000100010000000101
101011111011111110101
101010000010100000101
101010111010101111101
100010001010100010001
101011111010111110111
101000000010000000101
101111111111111011101
100010001000101010001
111110111010101010111
100010001010000010001
101010101011111111101
101010101000001000101
101010101110101010101
101000100000100010001
111111111111111111111
