111111111111111111111
101010001000101000101
101011101011101110101
100010001000001010101
101111101011111010101
100010101010101000001
101110101010101110111
100000000000000000001
101010111010101010101
101010101010101010101
111011101011111010111
100010000000001010001
101111111010111111101
100000001010000010001
111011101111101011111
101010101000101000001
101010111011101010101
100000000010101010101
101110111010111011101
101000001000001000101
111111111111111111111
