111111111111111111111
100000100000001000001
111110111011101110111
100010101010101000001
101010101110101011111
101000000010000000001
111111111011101010101
100000100010001010101
101111101111101110111
100010101000000010101
111010101010111110101
100000100010001000101
101011101110111010101
101000001010100010001
111011111010111110111
101010001010100000001
101010111010101011101
100010000000101000101
101011101110111010101
101010000010100010101
111111111111111111111
