111111111111111111111
100010001000001000001
101010101110101110111
101000101000101000001
111110111111101011101
100000101000001000101
111110101010101110111
101000101010101000001
101010101111101011101
100010000000001000101
101111111010111010101
100000001010000010101
111011111111111111111
101000100010000010101
101110111011111010101
100000100000000000101
111110101111101010101
101000000010001010101
101010111011111110101
100010100010000000001
111111111111111111111
