111111111111111111111
100010000000000010001
101110111011111011101
101000001010001000101
101111111010111110101
100010000010000010101
111010111110111010101
101000100010001000101
101111101011101111101
100010001000001000001
101010111111111111101
101010100000000000001
111010111111101011111
100010000000101000001
101111111110101111101
100000001000101000101
101111101011111010101
101010001010000010001
101010111010111111101
100010000000100000001
111111111111111111111
