111111111111111111111
101010000000100000001
101010101111111111101
101000100010000000001
101011101111111010111
101010001000100010001
101110111110111010111
100000001000001010001
111110101010111011101
100000101010101000101
101010111110101010111
101010000000000010001
101110111011111011101
101010001000100000101
111010111011111011111
100010001000001000001
101010101111101011101
101010101000001000101
111010111110101110111
100000000010100010001
111111111111111111111
