111111111111111111111
100000000000100000001
111111101111111110101
100010001000100000101
101110111011101110101
100000000000101000101
111110111111101110111
101000100000100010001
101110101011101011111
100010001000101000101
101111101111111011101
101000100000000010001
101010101111101110101
100010100000101010101
101111101110111010101
100000001010100000101
101111101010111110111
100000101000001000001
111011101110101010111
100000101000100010001
111111111111111111111
