111111111111111111111
100000101000000000001
101010101011111110111
101010100010000000001
111010101111111011101
101010000000100000101
101110101111111011111
101000101000000000101
101110111110101010101
100000001000101010001
101110111110111110101
101000001000000010101
111110111010101010101
101000001010101010101
101110111110101010111
100000000010101010001
111010101110101111101
100010101000100010101
111110111110101110111
100000000010100000001
111111111111111111111
