111111111111111111111
100000100010000000001
111110111010111111101
101010000000101010101
101011101011101010111
100010001000000000001
101111111110111111111
100000100000101010101
101110101110101010101
101010001010000000001
111011111010111111101
100000000000000000101
101110101110111111111
101000101010000000101
101110101010111111101
101010101000000000001
101011111110111110111
101000000000000010001
111010111110111011101
100010001000100000101
111111111111111111111
