111111111111111111111
100000100000000000001
101011101111111111101
101000100000100000101
101110111110101110101
100010000000100010001
111111111011111011101
100000001000001000101
101111101111111110101
100000101000000000101
111110111011111111101
100010100010100000101
101110101110101110101
100010001000101010001
101011111110101011111
101000000000101000001
101111111010101011101
101000101010101000101
101010101011101111101
100010001000000000001
111111111111111111111
