111111111111111111111
100000000000000000001
111111101111111011101
100000000010000000101
111111111111101010101
100010001010001010101
101111101011111110111
100010001000000000001
111010111011111010111
100010000010000010101
111010111111101110101
101000001000001000001
101010111110101110111
100010100000100010001
111010101110101111101
100010101000101000001
111011111011101110101
100010001010000010101
111010111110101110111
100000001000100010001
111111111111111111111
