111111111111111111111
100000000010001000001
101111101110101010111
100010100000100010001
111010111110111111101
101010100010001000001
101010111011111011101
101000101010000010001
101110101010111110111
100000101010001000101
101111101011101011101
101000001010001000001
101011111010111111101
101000100010100010001
101110101110111010111
100010100010001000001
111010111011101111101
101000101000100010001
101110101110111010111
100000000010000010001
111111111111111111111
