111111111111111111111
100000001000001000001
101111101010101110101
101010001010101000101
101010101011101011111
101010101000100010001
101010111110111110101
101010000010100000101
101011111010101111101
101010001000100000101
101010101011111110101
100010101000000000101
111110101111111011101
101000101000001000101
101010101011101110111
100010100010000010001
111010111111111111101
100010000000100000001
101110111111101111101
100010000000001000001
111111111111111111111
