111111111111111111111
100000000000000000001
101111111010101110101
100000001010101000101
111011111110101111101
100000100000100010001
101011101110101111101
101000101000100000101
111111111011101110101
100000000000100010101
101010101110101111101
101010100010100010001
101111111011101110111
100000001000101000001
101111101110111111101
100010001000000000101
101011111110101110111
101000001000101000001
101010111011101010101
101010100010001010101
111111111111111111111
