111111111111111111111
100000000000000000001
101111101010101111101
100010001010100000101
111110101110111111111
100000101000000000001
101110101110111010101
101000101000001010101
101010111011101111101
101010001000101000001
101010111110101111101
101010001000101000001
101111111011111011101
100000001010000010001
101111111111101110111
100000000010001000001
111011111111111110101
100000000000100000101
101011101111101110101
101010000010001000101
111111111111111111111
