111111111111111111111
100000000000000010001
101110111110111110101
101000101000001010101
111111101110111010111
100000000000001010101
101011101110111010101
101010001010100010101
111111101010111010101
100000001000000000001
111111101010101110111
100010001010101010001
111011111111111010111
101000000000001010001
101011101110101010111
100000101000100000001
101011111011111010101
101010000010000010101
101011111010111010111
101010000010100010001
111111111111111111111
