111111111111111111111
100000100010001000101
111110101010101110101
101000001010100000101
101011111011101111101
101000100000001000101
101110101110111110101
100000100010000000001
111111101111111111101
100000100000000010101
101110101111111110101
101010100010101010101
101010111010101010101
101000000010000010101
101011111010111110101
101000100010000010101
101110101110101010101
101000100000101000101
101011111011111110101
101000100000000010101
111111111111111111111
