111111111111111111111
100000100000000010101
101111111111111010101
100010000010000000001
101110101011101010111
100010101000001010001
101110111110111111101
100010100000000000101
111011111110111111111
100000100000000000001
111110111010111010111
101000001010100010001
101011111011101110101
100010000010000010101
111011101111111011101
100000001010001000101
111110111010101011111
100010100000100000101
101110111010101111101
100000001010100000001
111111111111111111111
