111111111111111111111
100010000000100000001
101110111011101110111
100000101000001010001
101111101111111011101
101000000010000000101
101110111010101111101
101000101010101000001
101011101010101011111
100010000000101010001
111111101111111011101
100000100010001010001
101110111010101010111
101000101010100010001
101011101010111011101
101010000010100000101
101011111110111110101
101000000000100010101
101111111111101011101
100000000000001000001
111111111111111111111
