111111111111111111111
100010000000101000001
111011101110101111101
101010001000000010101
101011101011101010101
100010001000101000001
101111111111101011101
100010100000101010001
101110111010101110111
100000100010001000001
111010101110101011101
100010000010101000101
111111111111111111101
100000000010100010001
111011101110101111101
100000100010101010001
111010111010101011101
100010100010100010001
111110111010111011101
100000100000000000001
111111111111111111111
