111111111111111111111
101010000000000000101
101011111111111011101
100010100010100010101
101110111010111010101
101010100000000000101
101010111011101110101
100010100000100010101
111010111011111111101
100010100000100010101
101110111110101110101
100000100010101000001
111010101010101010101
100010001000000010101
111111111111111011101
101010001000000000101
101010101010101010101
101000100010101010101
101111101110101011101
100000001000101000101
111111111111111111111
