111111111111111111111
100000000000000000001
111010111011111110111
100010001010000000001
101111101010111111111
100010001010000000001
101011101011111010111
101010001000001010001
111110111011101110101
100000001000101000101
101110111111101110111
100010100000000010001
101111111111111011101
101000000000000000101
111110111010111111111
100000001010000000001
101011101110101011101
101000101000101000101
101110111010101111101
101000001010101000001
111111111111111111111
