111111111111111111111
100000100000001000001
101011111110111011111
101010000000000000001
111010111110101010111
100010100000101010001
111010111011111111111
100000100000101000001
111110101010101010111
101000101010001010101
101111111110111110101
100000001000001000001
101111101110101011101
101000000010100000101
111011101110111110111
101010000000001000001
101011111111101010101
100010000010001010101
101010111011111110101
101010100000000000101
111111111111111111111
