111111111111111111111
100000001000100000101
101111101010101110101
100000100010101000101
111011111110101011101
101000100010001000001
101110111011111110111
100000001000001010001
101111111111101010101
101010000010001010101
101010101110111011101
100000100010100010001
111111111010101110101
100000001010101000101
101111101010101011101
101000100010100010101
101010111110111110101
101010100010100010001
101010101010101010111
100010001000101000001
111111111111111111111
