111111111111111111111
101000001000000000001
101010101110111011111
101010100000101010101
101010111110101110101
100010100010101000001
111110101011101111101
100000001000001000001
101010111011101111101
101010100010001000101
101111101011101010101
101000001000101010001
111110111111101111101
101010100010100000101
101010101110111010101
100010100000000010001
111011101111101110111
101010001010001010101
101010111011101010101
100000000010000010001
111111111111111111111
