111111111111111111111
101000001010100010001
101011111010101111101
100010100010000000001
101110111011101110111
100010000010101000001
111011101010111110111
101010101010101000101
101010111010101110101
101000100000001000101
101110111110111011101
100000101000000010001
101110101111111010101
101000000000000000101
111110101010101011101
100000101010101010101
101111111111101110111
101010000000000000001
101010111010101011101
101000001010101000101
111111111111111111111
