111111111111111111111
100000100000001000001
101110101111101010111
101010100000101010001
101010111110101011101
100010000000101010001
111011111111101010111
101000100000101010001
101110101110101011101
100000100010100010001
111111111010111110101
100000000010000000101
101111111110111111101
101000000000100000101
101111111111101110101
100000000000001010101
101111111111111010101
100000001000100010101
111111101010101010111
100000000010001010001
111111111111111111111
