111111111111111111111
100000001000100000001
111110111011101111101
100000100000001000001
101010101011111011101
101010001010001010001
111011111010101011101
100010001000101010001
101110111111111011111
100010001000100010001
111010101011111010101
100000101000000000101
101111111110101110101
100000001000100010101
111010101111111110111
100010101000000000001
111111101111111111111
100010000000100010101
111010101010101010101
100000101010001000001
111111111111111111111
