111111111111111111111
100010001000000000001
101110101011111011111
100010101010001000001
111010101011101011101
101000101000100010001
101111101110111010111
101000000010001010001
101011111011101111101
100010001000100000101
111110111110111110111
100010001000100000001
101110101011111111101
100010100000000000001
111010111110111111111
101000100010001000001
101111101111101010101
100010001000100010101
101110111010111111101
100000000010000000001
111111111111111111111
