11111111111111111111111
10000000001000000000101
11111010101110111110101
10001010100010001000101
10101110111010101011101
10100000101010101000001
10111111101010101111101
10100000101010100000101
10101110101010111110111
10001000100010001010001
11111011101111101011101
10001010001000001000101
11101010111111101010101
10001010100000100010101
10101010101110111111101
10101010001000100000101
10101011111011101110101
10101010001000101000101
10111110101110101110101
10100000100010100010101
10101111111010111010101
10000000001000000010001
11111111111111111111111
