11111111111111111111111
10001000100010101000001
11101110111010101011101
10000000100010100010001
11111010101110101011111
10000010101000001010101
10111011101010111110101
10001010001010101010001
10111010111010101010101
10001010000010100000101
10101111101111101011101
10101010000000001010001
10111011101111111010101
10001000000000001010101
11101111101011111010111
10000000001010100010001
11101110101010111110101
10000010101000100010101
11111110111110111010111
10000000001000000010001
10111110111110111010111
10100000100000100010001
11111111111111111111111
