11111111111111111111111
10000000000000000000001
10101110101010101110111
10100010101010101000001
10101111111011101010101
10100000001000101010101
10101011111010111110111
10101000001010100000001
11111011111010111111101
10000000100010000010001
11111011101010101011111
10000000101010101000001
10101110111110101011101
10100010001000101000101
10101110111010111011111
10101000100010001000001
10101110111110111011101
10101000000010001000101
10101010111010101110101
10101010100010101000101
10101111101111111010101
10101000000010000010101
11111111111111111111111
