11111111111111111111111
10000000000010000000001
10111111101010111111101
10001000101010100010001
11101010101110111010111
10101010100000000010001
10101110111111111111101
10100000101000100000001
10111110101010101011111
10100000101010001010001
10101111101011111111101
10100000001010000000001
10111110111010111111111
10000010100010001000001
10111010101111101011101
10001000100000001010001
11101111111111111010111
10001000001000000010001
10111011101110101111101
10100000100010101000001
10111110111011101011111
10000000100000001000001
11111111111111111111111
