11111111111111111111111
10101010001000100010101
10101011101011101110101
10000000001010001010001
11101110111011101010111
10001010001000001000101
11101011111111101011101
10100000101010000000001
10101011101011111011111
10101000000010001010101
10111110111111101010101
10001010001000000010001
10101010111111101010111
10100010101010001000001
11111010101011101111111
10000000001000101010001
10101110101011101010111
10100010100000000000001
11111110101011101110111
10000010101010100010001
11101011111010111110111
10001000000000000010001
11111111111111111111111
