11111111111111111111111
10000010001000000010001
10111110111111101110111
10000010000000001000101
11101011101111101110101
10001000001000000000001
10111111111111111110101
10101000100000101000101
11101011111010101110101
10100000101010001000101
10101111101111101011101
10100000100010000000101
10101111101011101111111
10100010101010001000101
10101010111010111010101
10001010100000100010001
10111010101111101011111
10001000001010001000001
10111110111010101010101
10100000100000101010101
10111011101111101011101
10001000000010001000101
11111111111111111111111
