11111111111111111111111
10001010000010100000001
11101010101110111110101
10100010101000000000101
10101111101010101110101
10000000100010101000101
11101110111111111011111
10000010100000100000001
11101011111010101010101
10001000000010001010101
11111010111011101111101
10101010100000101010101
10101111101111101010101
10000010000010000010001
11101110111110101111111
10001010101000100010001
10101011101011101010111
10100000100010001010001
11101010101111101111101
10101010001010000000001
10101111101010101010101
10000010001000101010101
11111111111111111111111
