11111111111111111111111
10000000100000000010101
10111010101111111110101
10101010100000000000101
10101010111111101110101
10101010101000001000101
10101010101011111011101
10001010001000001000001
11101011111110111111111
10001000100010000010001
11111110101011111010101
10000000101000000010101
10111111101111111110101
10100000100000100010101
10101110111110101010101
10000010000000101010101
11111011111111101010101
10001000000010001000101
10111111101011111111101
10100000101000000000101
10101110111111111010101
10000010000000000010001
11111111111111111111111
