11111111111111111111111
10000000000000000000001
11111111101010101111101
10000000001010100010001
10111010101111101011101
10100010100000101000101
11111110101110101011101
10000000101000101010001
10111111101111111111101
10100000000010000000001
10111110101010111010101
10000010101010100010101
10111010111011111110101
10001010100000000010101
11111011101011111111101
10000010001000000000101
11111011111110111110101
10000000100000000010101
10111011101010111111101
10001000101010001000001
10111011101011101110111
10001000101000100010001
11111111111111111111111
