11111111111111111111111
10001000000000000000001
10111111111111111011111
10001010100010101010001
10111010111010101010101
10000010100010001000101
11101010101010101011111
10001010001000100010001
10111010111111101011101
10001010000000101000001
11101010111111111111101
10001000101000101010001
10111010101010101010101
10001010000010001000101
10101011111111111011111
10101010100010000000101
10111010101010111010101
10001010001000001010001
10111111101111111111111
10001000001010100000101
11101011101010101110101
10001000100000000010001
11111111111111111111111
