11111111111111111111111
10000010000010000000001
11111010111010111111101
10000010100000100000101
10111010111111101110101
10001010100010001010101
11101010101110111010101
10001010101000001000001
10111110101011111011111
10000000100010100010001
11111010111010101110111
10001010001010001010001
10101011101111101011101
10100010100000100000101
10111110101110111111101
10100000101010000000101
10101111101010111110101
10101000001010100000101
10101011101011101011101
10001010101000101000101
11111010101010101111101
10000000100010100000001
11111111111111111111111
