11111111111111111111111
10001000001010000000001
10101011101010111011101
10100010101000100010001
10111110101011101111111
10100010100010001000001
10101010111111111010111
10001000100000000010001
11111011101110111111111
10001000100010100010001
10111110111110101011101
10000010000010101000001
11101011111010101011111
10001000000010001010001
11101111101110101011101
10001010001000101000101
10111010111111101010101
10001010101000001010101
11101010101011111010101
10001010001000001010101
10111010111111101010101
10000010000000001010001
11111111111111111111111
