11111111111111111111111
10000000000000000000001
11111011101110101111101
10000010000010100000101
10111011101111101111101
10001010000010000010001
10111110101110101010101
10000010101000101010101
10111010101011111010111
10100010101000001010001
11101011111010101110101
10001010000010101000101
11101011101110101010111
10001000101000101010001
10101111101110111110101
10100010000010000010101
10101010111010101110101
10101010100010101000101
10111111111011111111101
10000000001010000000001
10111010101010111110111
10001010101010000010001
11111111111111111111111
