11111111111111111111111
10000010001000000000101
10101110101010111110101
10100000100010001010101
10111111111111101010101
10001000100000101010101
11101010111110101010101
10101010000010101000101
10101011111010101011101
10100010001000101010001
10111110111110101010101
10000000100000101000101
10111110101111101111101
10100010001000001000101
10101011111011111010101
10001000101000000010101
11111110101111111110111
10000010100000100010001
10111110111110101010101
10000010100010101010101
10111010111010101011101
10001000000010001000001
11111111111111111111111
