11111111111111111111111
10000000100010000010001
10111111101010111010101
10000010001000100000101
10111010111111101111111
10001000001000001000001
11101110111010111011101
10001000100010100010001
10111011101110111110111
10001000101010000010001
11111111101011111011101
10000010000000001000101
11111010111111101011101
10000010100000101000101
10111110111110111010101
10001000100010100010101
11101011101010101110101
10001010001000100010101
10111010101111111010101
10000010101000001010101
11111110111011101010101
10000000000010000010001
11111111111111111111111
