11111111111111111111111
10000000000000100000001
10111111111110111011111
10100010000010000010001
10101010111011111110101
10101000001000000000101
10101111111111111111101
10000010001000001000001
11111011101011101010111
10001000101010001010001
10111010101010111011101
10100010001010001010001
10101111111111101011111
10101000100000100010001
10101110101110111110101
10101000101000100000101
10101010101011101111101
10100010001010100010101
10111011111010111010101
10100010001010000010101
10111110111011111010101
10000000000000000010001
11111111111111111111111
