11111111111111111111111
10000000000000000000101
10111111111011111110101
10000010000010000010001
11111110111110101011101
10000000100010101000101
10101111101011101011101
10101000001000101010001
10101011111110101110111
10101010000010101000101
10101010111010101011101
10101010001010101010001
10111011101010101011101
10100010101000101010001
10101110101111101010101
10100010101010001010101
10111010111010101010111
10001010100010100010001
11101010101010111111101
10100010001000100000101
10111110111111101110101
10000000000000001000001
11111111111111111111111
