11111111111111111111111
10000000001000000000001
11111110111010101111101
10000000100010101000101
10111011101110111010101
10001010001010001010101
11101110111011101010101
10001000100000100010101
10111011111110111110101
10000010000010100000101
10111111101010101111111
10101000001000100000001
10101010111111111111101
10100010000000000010001
10111111111111101010101
10100000001000001010101
10101111101011111010111
10101000100010000010001
10101010101111111111101
10101010001000000000101
10101011111011111110101
10001000001000000010001
11111111111111111111111
