11111111111111111111111
10101010001010101000101
10101010111010101110101
10101010001000000010101
10101010111110111110101
10100010001000001000001
10111010111110111110111
10100000100010001000101
10111011101110111110101
10100000100000101010101
10111110111011101010101
10001010101010101000001
10111010101010101111101
10100000000000000000101
10111111111111111011101
10000010100010001000001
11101110111010101010101
10000000000010100010101
10111010101111101011101
10100010100000001010001
10111110111011101011101
10100000100010001010001
11111111111111111111111
