11111111111111111111111
10001010000010100000001
10111011111010111011111
10100000001000000000101
10101111101111101110101
10000000100010101000001
10101011101010111011101
10101010101000101000101
11101110101011101110111
10001000101010000010101
11101011101010111010101
10001000001000001000101
11111110111011101110101
10000000100010001000001
11101011111110111110111
10001000101000101010101
10101011101110101010101
10101000101010100010001
10111110101010101111111
10100000000010000010101
11111110111111101010101
10000000001000001000001
11111111111111111111111
