11111111111111111111111
10000000100010001010101
11101111111011101010101
10000000000000000000001
11101111111111101111111
10101010000000100000001
10101010111110101110101
10000000100010100010101
10111011101111111111101
10100000000000100000101
10101111101010101011101
10101000001010001000101
11111011101110111011101
10101000101010001010001
10101010111011101110101
10000010000000100010101
10101111111111111111101
10100000000000000010001
10111011111010101011111
10100000100010101000101
10101011111010111010101
10101000100010100010001
11111111111111111111111
