11111111111111111111111
10000000000010000000001
10111111111010111111101
10100000001000001000001
10101011111111101111111
10101000100000100000101
10101110101110111010101
10100010000010001010001
10111011111011101111101
10101000101000100000001
10101110101110111111111
10001000100010000000001
11111011111011111111101
10000010000000001000001
10111011111110101011111
10001010000010101000001
10101110111011101111101
10100000100010001000101
10111111101110101010111
10100000100010100010101
10101110101110111110101
10001000100000100000001
11111111111111111111111
