11111111111111111111111
10000000001000000010001
11111011101110101110101
10000010100010101000101
10111110111011101011101
10100000001000100000101
10101110111110111111101
10100010000010100010001
10111111111010101010101
10100000100010101000101
10101110101110101111101
10000010100000001000001
11111110101111111011111
10000010101000100010001
10111010101010111110111
10100000101010100010001
10111111101010101011101
10000010001010101000001
11111010111010101111111
10000010001010101000001
10111111111010101011101
10000000000010000010001
11111111111111111111111
