11111111111111111111111
10000000000000000010001
11111011111111111010101
10001010000000100010101
10101010101111101110111
10100010100000001000001
10111110111111111011101
10000010001000001010001
11111011101011101010111
10000010001000100010001
10111110111111111011101
10100010100010001010001
10111010101010101110101
10001010001000100000101
10101011111111111111101
10101000100000000000001
11101010101111101111111
10001010001000101000001
10111011111010111011101
10100010000010100010101
10111110111110101110111
10000000000010000000001
11111111111111111111111
