11111111111111111111111
10000010001000101000101
11101110101011101011101
10100000101000001000001
10111010111110101110101
10000010001000100000101
11111011101110101011111
10000010000000101000001
11111110111111111010111
10100000000010001010001
10101111111110101011111
10100000001010101010101
10111110111011101010101
10000000101010101000001
10111011101010101011111
10100000100010001000001
10111011101010111011111
10100010001010101010001
10101010101010101010111
10101000101000001000001
11111111101111111111111
10000000000000000000001
11111111111111111111111
