11111111111111111111111
10100000001000101000001
10111110101010101110111
10100000101010000010001
10101011101011101010111
10001000100000101000001
10111111111111111110111
10101010100010100010101
10101010101110111010101
10101000000010000000101
10101011101111101110101
10101010000000000010101
10101010101011101111101
10101010101010000000001
10101111111011111110111
10100000100010100000001
10101010101010101111101
10101010001010100000101
10101111101110101011101
10101000000010001000101
10101010111010101110101
10101010001010101000101
11111111111111111111111
