11111111111111111111111
10001000000000100000101
10101110111111101010101
10101000000010101010101
11101010111010111011101
10001010100010100000101
10111011111110101111101
10001000001010100000101
10111110101010101111101
10000000100000001010101
11111011111111101010101
10001010100010100000001
10111010101110101111101
10000010000010101000101
10101010101110101010101
10101000100000100010101
11111011111111111111101
10001010000010101000101
11101010101010101110101
10000000101010001000101
10101010111010101110101
10101010001000100000101
11111111111111111111111
