11111111111111111111111
10000000001010000000001
10111111101010111110101
10000000100010100010101
10111110111110101011101
10000010001000101000101
10111110101011101110101
10100010100010100010001
11101011111010111011111
10101010001000001000001
10101010101111101111101
10101000101000001000101
10101111101011111011101
10101000001010000010001
10101011111011111010101
10001010001000000010101
11111010111111101110101
10000010000010001000101
10111111111010111011101
10001000001000100010001
11101011101111101110111
10000010000000001000001
11111111111111111111111
