11111111111111111111111
10100000100000001000001
10101110101111101010111
10001010100000101010001
10111010111111101111101
10100010000000101000001
10111011111110101011101
10100000100010001010001
10101110111011111010111
10100010000000000010001
10111011111111111111101
10001010000010001000001
11101010111011101011111
10101010100000001000101
10101010111110111110101
10001010100010100010001
10111010101011101011101
10000010101000001010001
11111110101111111010111
10000000100010001010001
10111111111011101011101
10000000000000001000001
11111111111111111111111
