11111111111111111111111
10000010000010001000001
11111010111011101010111
10000010001000100010001
10111111101111111011101
10000010001000001010001
10111010111011101110111
10001000100010100010001
11101111101110111011101
10101000001000100010001
10101111101010101110111
10001000001010100010001
10111011111110111011101
10100010000000101000001
10101110111110101111101
10001000100000100010001
11111010101111101010111
10000010100000001010001
10111110111111111111101
10001010000000000010001
11101011111111111010111
10000000000000001000001
11111111111111111111111
