11111111111111111111111
10000000000000000000001
11101011101111101011101
10001000100000101000101
10101011111111101110111
10101000000000101000001
10101011101011101011101
10101010001010001010001
10101110101010111110111
10101000101010000010001
10111011111111101111101
10100000000000100010001
10111011101110101110111
10001000101000101000001
11101110111011111110101
10000010100000100000101
10111010111110101010111
10100010100000101010001
10111010101110101110111
10001010101000100010001
10101010101010111010101
10101010101010100010101
11111111111111111111111
