11111111111111111111111
10000000100000000000001
11111110101111111111101
10100000100010000010001
10101111111010101010111
10100010000010101010101
10111010111110101010101
10000010100000101010001
10111110101111111010111
10000000100010000010101
11111011111110111110101
10001010000000100010001
10111010111011101011111
10001010100000101000001
11101011101110101111101
10001000100010100000101
10111110111011111010111
10100000100000100010001
10101111101110101111101
10000010001000101000101
11111011111010111010101
10000000000010000010001
11111111111111111111111
