11111111111111111111111
10000000100000000000101
11101111111011111110101
10001000000000100000101
10101011101111101110101
10101010001010100010101
10111010101010111011101
10001010101010001010001
10101111111010111010111
10100010000010000000101
11111011111011101010101
10000000100000001010101
11101011111011101111101
10101000100000101000001
10111110101010111011101
10000010001010000010101
10101011101110101110111
10101000101000100000001
10111110101010101110101
10001000001010100010101
11101110101111101111101
10000010101000000000101
11111111111111111111111
