11111111111111111111111
10000010001000101000001
11101111101110101111101
10001010001000001000001
10111011101110101110111
10101000101000101000001
10101010101111101110111
10000010000000001000001
10111111111111111010111
10101010101010001010001
10101010101010101111101
10001000000000101000101
11101011111110111110101
10000000101000100000001
10101110101011101111101
10101000001000001000001
11111111101010101011111
10000010001010101000001
10111010101111101111101
10001000101000001000001
11111111111111101011101
10000000000000001010001
11111111111111111111111
