11111111111111111111111
10101010101010000000101
10101010101010101111101
10100000001010100010001
10111011101010101010101
10000000100000101000101
11111011111111111111111
10000010000000001000101
11111011111111101010101
10100010000000101010001
10101010111110101111101
10001010001000101000101
10111111101010101011101
10000010001010101000001
11111010111111101111101
10000010000000001000001
11111011111011111011111
10101000000000100010001
10101011111010101010111
10001010100010001010001
10111010101011101010111
10000010001010001000001
11111111111111111111111
