11111111111111111111111
10000000000000000000001
11111011111010111010111
10000000001010001010001
10101110111111111110101
10101000001000000000101
10111010101110101111101
10100010100010100010001
10101010101110101011101
10101010101000101000101
10111110101110111110101
10000010101000100000101
10101011111011111011101
10101000001000001000101
10101010111110111010101
10101010000010001010101
10101111111011111010101
10101000000010000010101
10111010101111101111111
10100010101000000000001
10101011111111111110101
10101000100000000000101
11111111111111111111111
