11111111111111111111111
10000000100000000000001
10111110101111111111101
10100000101000000000001
10101111111011111111101
10101000000010000000101
10101111101110101110101
10101000001000101000101
10101011111011101011101
10100010000010001010001
10111110111110111010111
10000010100010001010101
11111110101111101110101
10100010101000100010001
10101010101010111011101
10001000101010001000101
10111111101011101011101
10001000000010001010001
11101011111110101010111
10101000000010101000101
10101111111110101111101
10000000000000100000001
11111111111111111111111
