11111111111111111111111
10000000001010101010001
11111011111010101010101
10101000101000101000101
10101011101110101110111
10000000000000000000101
11101111101111101111101
10001000000000101000001
10111111101111101011101
10100010100000101000101
11101110111011111011101
10000000000010001000101
10111111101111101011101
10101000000000101010101
11101011111110101010101
10100000100010100000101
10101011101111111110111
10001000000010000000101
10111111101111101010101
10100000000000001010101
10111111111110101011101
10000000000010101000001
11111111111111111111111
