11111111111111111111111
10000010001010000010101
10101010101010101010101
10101000100000101000001
11111110111111111111111
10000000001010000000001
11111111101010111111111
10001010000010001000001
10101010111010111011101
10100000001010001010001
10111110111011101011111
10000010101010101000001
10101010101010101011111
10101010001010000000101
11111111101110111010101
10000000000010001010001
11111111101111101111111
10000000000010001000101
11101111111111101110101
10000000100010000000001
11101010101010111011101
10001010001000001000101
11111111111111111111111
