11111111111111111111111
10001000100010000000001
10111011101011111011111
10001000001000101000001
10111011101111101110101
10100000100000100000101
10111110111011111111101
10100000001000001000001
10111011101111111110101
10001010000010101000101
11101110111110101110111
10100000100010001010101
10101011101011101010101
10001000101010100000001
10101110111010101111101
10100010000010100000101
10111110101110111110111
10100000100000000000101
10101110111010111010101
10100010001010001010001
11101011111110101011111
10001000000010101000001
11111111111111111111111
