11111111111111111111111
10100000100010000000101
10101110101111111010101
10000010100000100010001
10111011101010101111111
10100010001010001000101
11101010111111101110101
10001000101000001010101
10101011101110111010101
10101010000010101000001
10111010111011101010111
10100000101000100010101
11101010101011111110101
10101010100000001000001
10111010111111111010111
10000010000000100010001
11111011111011101111111
10000010000010000000001
10111110101011101011111
10000010101000101000001
11111011101110101011111
10000010000010001000001
11111111111111111111111
