11111111111111111111111
10100000001010100000101
10111010111010111011101
10001010101000100010001
10111011101110111011101
10101000100010000000101
10101011101110111111101
10101000001010101000101
10101110111010101011101
10001010001000001010001
11101010111110111011101
10101000101000100000101
10101110101011101111101
10101000101000101000001
10101110101110101111101
10001000001000000000001
11101110111011101110101
10001000101000101010101
10101110101011111010111
10101010000010000010101
11101010111111111011101
10000000000000000000001
11111111111111111111111
