11111111111111111111111
10000000000000000000001
10111011111110111010101
10100000000010001010101
10101010111110111111101
10101010100000100000001
10111011111011101110111
10001000001010001000001
10101011111111111010101
10101000100000000010101
11101111111010111111101
10000010000010000010001
10111011101010111110101
10100000101010001000101
10101111111010111111101
10100000100010000000101
10101010111011101010111
10101010001000101010001
10101011111011101010101
10101000001010001010101
10111010101011111111111
10001010101000000000001
11111111111111111111111
