11111111111111111111111
10000000000000000000001
10101011111011101111101
10101000001000100000101
10111011111111101010101
10001000000000101010101
10111111101110111110101
10001000000010000010101
10111011111111111110111
10100000000010000000001
11101011101010111111101
10001000101010001000001
11111011111010101110101
10000000001010100010101
10111110101011101111101
10001000101010000010001
10111010111010101111101
10001010100010100000101
11101010101111101110101
10001010101000000010101
10101111111110111111101
10101000000000000000101
11111111111111111111111
