11111111111111111111111
10001000000000000000001
10101111111111111111101
10100000000000100010101
10101111111110101010101
10100010000010001010001
10111010111010111010111
10100010100010001010101
10101110111111111010101
10100000100000000010101
10111110101111111110101
10100000101000000000001
10101111101011111111111
10100000100010000010001
10111110111110111011101
10100010000010100000001
10101010111110101111111
10101010100010100000001
10101011101010101111101
10001000101000101010001
11101010101111101010111
10001010001000001000001
11111111111111111111111
