111111111111111111111111111
100000000010101010100010001
111111101110101010101110101
100000001000001000000010101
111111101110111011111111101
100000101010001000101010101
111110101010111011101010101
100000000000100010000010101
111011111011111010111110101
101010001000100000101000001
101110111011111110101110101
101000000000000000100000101
101111101011111110111011111
101010001010100000100000001
101011111110111010111011111
100000101000001010001000001
111110101111101110111011111
101000101010000000000000101
101110101011111110101111101
100000100000100000100000001
111110101010111111101010101
100000101010101000001010101
101010111011101110101111101
101010000000000010100000101
111011101111111010101011111
100010001000000000101000001
111111111111111111111111111
