111111111111111111111111111
100000100010000000000010001
111010101010111111111011101
100010001010000010001000001
101111111011111010101111101
100010001010001010100010101
111010111011101010111010101
100010000010001010101000101
101111111010111010101111101
100000001000000010100000001
101111101011111110101111111
101010001010001000100010001
101010111110101011111010101
101010001000100000001010101
101011101011111111111011101
101000001010001000001010001
101111111010111011101010101
100010001010000010101000101
101010101011111110101111101
101010101000001000100010001
111010101111101010111010111
100010100000101010000010101
101110111110101011111010101
100000101000100010000010101
111011101011111110111110101
100000001000000000100000001
111111111111111111111111111
