111111111111111111111111111
100000100000000000100000001
101110101111111110101011101
100010001000000010001010001
111011111110111011111011111
101010000010001000001000001
101010101011111010101111101
101010101000001010100000101
101010101111101110111011101
101010100000101000100010001
101011111110101010111110111
101010001000101010100010001
101010101011101010101011101
101000100010000010101000001
101011111011111111101111101
100010001010000000001000001
101110101110111111111011111
101000100000100010000000001
111011111111101010111110111
100010000000001000100010101
101011111111111111101010101
101010000000100010001010101
101110111110101010111011101
100010100010001000101000001
101010101011111111101111111
101000001000000000000000001
111111111111111111111111111
