111111111111111111111111111
101010000010001000000000001
101010111110101111111011101
101000000010101010000000101
101110101111101011111011111
100000100000001010001000001
101110111010111010111011111
101000001010000010001000001
111110111111101111101010101
100000001010100000000010101
101111111010111111101011101
100010000000000000001000101
111111101011111011101110101
100000101000001010001000101
101111111010111010111110111
100010000010100010001000001
111010111010111010101111101
101000001010001010100000101
101110111011111110111111101
100000100000001000100000001
101010111011111110111110111
101010100000001010001000001
101111111110111010101011111
100000100010101000101010001
111110111011101011111011101
100000000000001010000000001
111111111111111111111111111
