111111111111111111111111111
101010100000001000100000101
101010101010101110111010101
100000001010100000100010001
111111101111111111101011101
100000000010000010101010001
101111111011111010111111101
101010001010001010100000001
101011101011101010101111111
101000000010001010101000001
101111101010101010101010101
101000001000100010101010101
111111111110111110101111101
100010101000100000100010001
101110101110101010101010101
100000001000101010101000101
111110101110111010111110111
101000101000100010000000001
101010101010101010111011111
100010100010001010101000001
111110111111111111101111101
100000001000001010101010101
101110101011101010101010101
100010100010001000100000001
101110101010111110101011111
100010101010000000101000001
111111111111111111111111111
