111111111111111111111111111
101000000010100000101000001
101110111010101010101011101
101000100010001010000010001
101110101110111010101010111
101000100000100010101010001
101111111011111111111111111
101000000010101000100010001
101010111110101010101010101
101010001010100010101000101
101010111010111110111011111
101010000000100010000000101
101010111110101010101010101
100010000010101000101010001
101110111111101111111111111
101000100000101000001010001
101010101110101011101010111
101010001000101000100010001
101111101111101010111010111
101000100000100010100010001
101110101111111111101111101
101000001000100000000000001
101011101011101111101011101
101000100000001010101010001
101011101010101010101010111
101000101010100010001010001
111111111111111111111111111
