111111111111111111111111111
100000100000100000100000001
101110101011101110101110101
100010101000001010101010101
111010101111111010101010111
101010001000001010100010001
101011111111101010111011101
101000000000101010001000101
101011111010101011101111101
101010001010001000001000001
101011101011111111111011101
101000101000100000000000101
101110101010111111111111101
101000001010000000000010001
101111111011101111111010111
100010100010101000100010001
111010101110101010101111101
101000101000001010001000101
101011101111111011111010101
101000001000000010000010001
101111111011111111101111111
101000000000100000001000001
101011111110101111111011111
100010100000100000100000001
101110101111111110111111101
100000100000000000000000001
111111111111111111111111111
