111111111111111111111111111
101000100000100000000010101
101110111110101111101110101
101010100000001000100000001
101010111111101011111011101
100000100000100010100010001
111010101011111010101011111
100010001000000010001010001
101111101111111010101010101
101000001000000010101010101
101111111010101111111110111
101010001010100010100000001
101010111110111010111110101
101010100010001000001000101
111010101010111111101011111
100010101000100000000000101
111010111110111111111110101
100000100000100010000010001
111011101110101010111010111
100010101010001010001000001
101110111011101111101010111
100000100000000010001010001
101111101111111011111111101
100010000010000010101000001
101110101111111010101011111
100000100010000000001000001
111111111111111111111111111
