111111111111111111111111111
100000000010100000001000001
111011111110101111111110111
100010001010001000001000001
101110101010111111101110111
100010101000000000000000101
111010101110111111101111101
101010101010000010100010101
101010111011101010111110101
100000100000001010100010001
111011111011111110101110111
100000000010000000001000001
101110111110101111101111101
101000101010100010000000001
111010101011111110111110111
101010000010001000001000001
101110111011101011111111101
101000001000000010000010001
101111111011111011111010111
100010101000100010000000001
101110101011101011101110111
100010000010101010001000001
111010111010111111101111101
101000001010000000001000101
101011111111101011101010111
100000001000001010000010001
111111111111111111111111111
