111111111111111111111111111
100010000010000000000000001
111011111010101111101110111
100010100010101010101000001
111010111011111010101110101
100000100000001010101000101
111110101111101010111011101
100000001000100010000010001
111111111110111011111110101
100000001000000000000000101
111011101110111011101011101
100010000010100000101000101
111111111011101011111011111
101010000000001010000000101
101010111110111011101110101
101000100000101010001000001
101011111110101111111010111
100010000000001000100010001
101011101011111110101110111
101010001000000010000010101
101110101110111111111110101
101000101000000010000000001
101110111110111111101110101
101000100000101000001000101
101010111110101110101011101
101010001000001000101000101
111111111111111111111111111
