111111111111111111111111111
100010000000100010000000001
111010111111101010111111101
100010000010001000000000101
101110111010111111101111101
100010001000001000101000101
111011101111111010101010101
101010001000000010101010001
101011111011111110101011101
101000001010000010101000101
101111101010111010101110111
100000101000001010101010001
111110101111111010101011101
100000100000000010100010001
101011111111111110101110101
101010000000100010101000101
101010111110101010101011101
101010101000101000101000101
101110101011101111111110101
100000101000100010000000101
101111101110111010111111101
101000000010100010100010001
101111111010101110111010111
101000100010101000100010101
101010101010101011101110101
100010001010000010000000001
111111111111111111111111111
