111111111111111111111111111
101000101010100010000000001
101110101010101010111111101
100000000000001000001000101
111010101110101110111011101
100010100010100010001010101
101111101010111110111010111
100010101010100000000000101
101010101111111011101111101
101010000010000010000010101
101111101110111111101110101
100010001000100010000000001
101110101011111011101011101
100010101010100000001000101
101011111010111110101110111
101010000010000000100010001
101010111111101110111111101
101010001010101010000010101
111110111010111010111010111
100000001000000000100000101
111010111110101011111010101
100010000010101000001010101
111111111110111011111110101
100000000000100010001010001
101110101011111010111010111
101000101000100000001000001
111111111111111111111111111
