111111111111111111111111111
100010100010000000000000001
101110111010111110111011111
100010001000001010001010101
101110111110111011111110101
101010100010001000001010101
101010101110111011111010101
101010101000001000100010101
101010101110111011111010101
100010000000001010100000101
111011101010111010111011101
101000001010000000000000001
101110101111101110111011101
100000100000100010001000101
101111101110111111101111101
101000001010001000000010001
111111101011111110111011101
100000000000000010100000101
101110111011111110101110111
101000001010000010100010001
101111101111101111101111111
101000000000001010000010101
111011101110101011101110101
101000100010100000100000001
101010111110101110101011101
100010001000100010101010001
111111111111111111111111111
