111111111111111111111111111
101000000000000010000010001
101011111111111010101010101
100000100000000010101010101
111110111110111111101110101
101000000010100000001000101
101011111010101011111011101
101010001010101000000010001
101010101110101111111110111
101010100010100000001000101
101010111010111111101011101
100000100010001000001010001
111111101110101011111010101
100010001010101000100010101
101010101010111010101111101
101010100010001010100000101
101110111111101010111110101
101000100000100010000010001
101011111110111111111011111
101000000010000000001000001
101110101011111111101011101
101000101000100000001000101
101011111110101111101110111
101000001000101000100010001
101111101011101011101111101
100000001000001000001000001
111111111111111111111111111
