111111111111111111111111111
100000000000000000000000001
101111111111111111111111111
100000000010101010101000001
101111101010101010101010101
100000101000000000000010101
101011111111111111101111111
101000100000001000001010001
111011101111111111101010101
100000100000001010000010101
101111111110111011101010111
100000100010101000001000001
101111111010101011111111111
100000100010000000000010001
111011101110111111101110111
101010100010101000100000001
101010111010101010101010111
100010100000001010001010001
101110111011111010111110101
100000100000001010000010101
111011101011101010111111101
100000101010001010000010001
101111111010101111111110111
100010100010101000000000001
101110111111111111101111111
100000100000000000000000001
111111111111111111111111111
