111111111111111111111111111
100010101010100010001000001
101110101010101111101011111
100010000010001010001010001
101011101110111010101010111
101010001010001000101010101
101110111010111010111010101
101000001010001010100010001
101110111010111110111010101
100010101000001010100000101
101010101110111010111011101
101000101000100000000010101
111110101110111110111110111
101010100000101000000000001
101010111011101110111011111
100000100000000000100000101
111110111010111011111111101
101000000010101000001000001
101011101010101110111111101
100000101010000010000010001
101011101111101111111111101
101010001000000000001000101
101011101010101110101011101
101010101010101000100000001
101110111011101010101010101
101000000010001010101010101
111111111111111111111111111
