111111111111111111111111111
100010100010001010000010101
101010111010111010111110101
101000100000100000000000001
101010111110101010101111111
101010000000001010100010101
111111111010101110111110101
100000000010100010101010001
111110101011101111101011101
101000101010101000100000001
101111111010111011111010111
101010000000000010000010001
101011101110111111101011111
100000001000000000001000001
101110111110111010111010111
101000001000100010001010001
101010111010111010111111111
101010100010100010000010001
101111101010111010111110111
101000001010101010001000001
111110111111101010111011111
100000100000000010000000001
111110111111111011101111111
100000100000000010000000101
101110111011101010101111101
101000100010001010100000001
111111111111111111111111111
