111111111111111111111111111
100000000000000000000000001
111011101111111010101110101
100000101000000010100010101
101111111110101011101011101
100000001000101000101000101
101010111011111110101010101
101010100010000000101010101
101110111110111110111110111
101000000010000010001000001
111011101111111010101111101
100000100010000010101000001
111011101010111011101111101
100010001010100000101000001
101011111111111010111011101
101000100000000010100010001
101010101011111010111111101
101010101000100010001000001
111111111011111011101111101
100000000000001010001000001
101110111111111011101111101
101000001000000000100000101
111110101110101010111011101
100000101000101010001010001
111011101011111010111111101
100010001000001010100000001
111111111111111111111111111
