111111111111111111111111111
100010000010000010000010001
111010111010111011101110101
100010001000100010000000101
101111101111101110111111101
100010001000101000101000001
111010111010101010101011111
100010000010100010100010001
101011111111111110111110101
101010000000000010000010101
101110111011111010111010101
100000100010001010100000101
111111101011101011101111101
100000101010001000100000101
101110101110101110111110101
101010101000100010001000101
101010101011111110101110111
101000101000100000100010001
101110111110101111111011101
100010000010101000101000101
111011111010101010101110101
100010000010101010001010101
101010111110101011101010101
101010001000100000101000101
101011101010111111101011101
101000100010000000001000001
111111111111111111111111111
