111111111111111111111111111
101000001000100000001000001
101110101011111110111011111
101000100000000000100010101
101110101111111110111010101
100010100000000010100000001
101111101110101011101111101
100010001000101010001000001
101111101010101011101011111
100000001010101010101010101
111110101111101110101010101
100000100010101010001000001
111110111110101011111010111
100010001000001010000010001
101110111111111011101111111
100010001010100010000010001
101011101010111011101111101
101000001010000000100000001
111110111011111011111011101
100000001000000000001000101
111111101010111111111011101
100010000010100010000010001
101010111011111010111111111
101000100000000000100000001
101011111011111110101110101
101000100000100000000010101
111111111111111111111111111
