111111111111111111111111111
100010001000000010000010001
111011101110101010101011101
100000101000101000101000101
101011101111111111101011101
101010000010100010001000001
111010111010111011101010101
100000101000100000101010101
101011101110111011111110111
101000100000101010001000101
101110111011101010111010101
101000100000100000001010001
111010101111111111101111101
100010101000100010000000001
111110111110101111101110101
100010000010100010100010101
101111101010101110101111111
100000001010101010000010001
101011101010101011101010101
101010101000100010001010101
101010101010101011101110101
101010101010101000001010101
101010101010101111111011101
101000101010100010000010001
101011101011111010111110101
101000101000000000000000101
111111111111111111111111111
