111111111111111111111111111
101000001000001000000000001
101010101011101010111010101
100010100010000010001010101
111111111111111111101111111
101010000000100000000000001
101010111011111110111111111
101000001000101000001000101
101111111110101011101110101
101000001000101010001000001
101110101110101011101110101
101000100000100010000000101
101011111111111111101111111
101010000010100000001000001
101011101010111110111011101
101010001010100000001010001
101010111110111111101011111
101000000010101000000010101
101010111010101110101010101
100010001000100000101000001
101111101111101111101111101
101000000000000000101000001
101111111011111111101110101
101010000000100000001000101
101010101010111111101110111
101000101010100000001000001
111111111111111111111111111
