111111111111111111111111111
100000100000000000001000101
101111101111111111101010101
100000000000100000101010001
111111111110111011101011101
100000100010100010001010001
101111101110101110111110111
101000100010100000000010001
101010111010101111101011101
100010001000101000101000101
111111101110101110111110101
100000100010100010001000101
101110101011111011101011101
101010001000000010001000001
101011101111111110111111101
101000000010000000100000101
101111111011101111101110101
100010001000100010001000101
101010111110111011111011101
101000100010001000001000101
101110111011101111101110101
100010100010001000101000001
111010101111101010101011111
100010101000001010100010001
101110101011111110111111101
100010001000000000000000001
111111111111111111111111111
