111111111111111111111111111
100000001000001000000010001
101111101010101011111010111
101010001010100010001010001
101010111110111110111011101
101000100000100010001000101
101110101111101110101110101
100010001000100000100010101
111011111011101111111010101
101000101000001000100010101
101110101011111010101010101
100010100000001010001010101
111010111111111011111110101
100010100000101000000010001
101010101110101011111011101
101010101010001010000000101
101110101011111110111011101
100010001000000000100010001
111011111011111111101110111
100010000010000000101000101
101110101010111110101011101
101000101010101000101000101
101011101010101011101110101
101010001010101010001000101
101010111110101011111011101
100010000000001000000000001
111111111111111111111111111
