111111111111111111111111111
100010100000100000101010001
111010101111101111101010101
101000101010100000000010101
101110101010101111101111101
100000001000101010000010001
101111101011101011111010101
100010001010001010001010101
111110101011101011101011101
100010100010000000100010001
101111101011111011111110101
100000101000000000001000101
101110101011101110101010101
101010001000100010100010101
101011111110111111111110111
100010000000000010001010001
101111101011111110111010101
101010101010000010100010101
111010101011111010101010101
100010001010000000101000101
111010111010111010111111101
100010101000100010101000001
111010101010111010101010101
100000100010001010100010101
111110101010111110111011101
100000101010000010100000101
111111111111111111111111111
