111111111111111111111111111
100010101000100000100000101
101110101010111011111010101
100000000010100000001010001
101010111110111011111110101
101010100010001010100010101
111111111010101010101010111
100000101010101000101010001
111011101011101110101111101
100010000000000010001000001
111011111011111010101011101
101000000000100000101000101
101111111110111111111011111
101000100000101010001000101
101110101110101010111010101
100000100010000000001010101
101010101111101010111010101
101010101010001010000010001
101011111010111011101110101
101010100010001010001000101
101110111010111110111110111
101000000010001000100000101
101011111011101111101111101
100000001010101010001010001
111110111010101010101011101
100000100000001000100000001
111111111111111111111111111
