111111111111111111111111111
100000000000000000000000001
111110111010111011111110101
100000100010001000000010101
111011111011101110101010111
100000001010000010101010001
101010111010111010101110111
101010100010100010100010001
111011101111101111111111101
100000100000100010000000001
101010111111101010101111101
101010000000101010100000101
111011111011101010111010101
100000001010001010001010101
101011111011101011111110101
101000100010001000001000101
111110101010101110101110111
100000101010101000100010001
111110101111101011101010111
100000101000001010001010001
101111111010101110101010101
100000001010101000101010101
111011101110111010101011111
100000101000001010101000001
101111111011111111101110101
101000000010000000000010101
111111111111111111111111111
