111111111111111111111111111
100000100000000000001000101
101110101111111011101010101
101000101000001010100010001
101011101011111010111111101
101000100010000010001000101
101111101010111111101011101
100000101010000010101000101
111110101010111010101110101
100010001010100010100010101
101111111010101110111010101
101000001010100010100010101
101011111010111010101110101
101000000010001010000010001
101111101011111010111110111
100000001010000000101000001
111111101110111111101011101
100000101000101000001010101
101011101011101011101010101
101010001000100000101010001
111010111110111111101111111
100010100000000000100010001
101010111111111110111010101
101010000000100010000010101
101111111010101011111110101
100000000010001000000000101
111111111111111111111111111
