111111111111111111111111111
101010101010000010001000001
101010101011101110111011101
100000100010100000101010101
111110101110111010101010111
100000101010100010100010001
101111101010111110101110111
100000000010001000001010101
111110111011101111101010101
101010101010000010000010001
101010101011101111101111101
100000101010100000101010001
111110101110101111101011101
101000000000001000100010001
101110101110101011101111101
101000101000101010101000101
101110111110111010101110101
100000100010101000000000001
101011101111101011111011101
101000100010000010001010101
101010101111101110111110111
101010001010000000000000001
111111101010111110101010111
100000001010001010101010001
101010101010111011111111101
101010100000000000000000101
111111111111111111111111111
