111111111111111111111111111
100000100000100010000010001
101110101110101011111010101
100010101000101010000010101
101110101011101010101111101
101000101000001000100000101
101011101111111110111110101
101000100010000010000010101
101110111010101111111010101
100010000010101000000010001
111011111010111011111111111
101000001000100000100000001
101011101111101110101111101
100010100000100010001000101
111110111011111011111011101
100010000010000010001000001
111010111110111110101111111
100010100010001000101000001
101010111011101011101010101
101010001000101010000010101
101011101010101110111110101
101010001010101000101000101
111010111011111011101011101
100000100000001010001010101
101111101111101010111010101
100000001000000010000010001
111111111111111111111111111
