111111111111111111111111111
100000000000100000001000001
101111111010111011101011111
100010000010001000101000001
111110111111101010101110101
100000100000101010100010101
101111101111101110111010101
100000101000000000100010101
111110101011111111101111101
100000100010001000001000001
101111101110111011111011111
100010100010100010000010001
111010111010101111101110101
101010000010100000100000101
101011111110111110111111101
101000001000100010100010001
101111101011111010101010101
100000101000001000101000101
101010101111101011101111101
101010101000001000001000101
101011101011111111111110101
101000101010100000100000101
101110101010101011101011101
100010100010101000001000001
111010111110101111111111111
100010000000000000000000001
111111111111111111111111111
