111111111111111111111111111
100000000000000000000000001
101110101010101010101010101
101000101010101010101010101
101110101011101010111111101
100010101000101010100000001
111010111010111110111110101
100010001010100000000010101
101110101111101110101110101
101000101000000010100010101
111111101111101110111110101
100000000000100010100000101
101110111011101011101111101
101000100000101010001000001
111011101011101011101110111
100000101000101010001000001
101110101010101011101011101
100010101010101010001010001
111011111110111110101110101
100000000010001000100010101
111110111111101111101011101
100000000000101000001000101
101111111111111010111010101
101000000000000010100010101
101010111110111010111010101
101010000010100010100010101
111111111111111111111111111
