111111111111111111111111111
100000000000000000000000001
101011111110111010111110101
101000000010100010000010101
101110101010111011101011101
101000101010100010001000101
101011111010101111111010101
101010000010101000000010101
111011111111111110101010101
100000000000100000101010101
101110101010101010101011101
100010101010101010101000101
111011111010101110111011111
100000100010100010100000001
101110101011111010111111101
100010101000001010100000001
111010111110101111111010111
100010000010100000100010001
111011111010111111111110101
100000001010000000001000101
101111111110111111111011101
100000100000100000000000101
101110101011101110111011101
100010101000101000100010001
101011101111111011101110101
101000101000000000100010101
111111111111111111111111111
