111111111111111111111111111
100010101000000010001000001
111010101111111011101010111
101000100000100000000010101
101010101111111110111111101
100010100000100010000000001
111110111010101011111010111
100000100010101010000010001
101111111011111010101111111
100000100010100000100000101
111010101110101111111011101
101010101010000000101000001
101110101011111111101011101
101000001000101000000000101
101010111011101010111110111
101010100000100010001010001
101110111010101011111010101
101000000010101000100010101
101011111111101111101011101
101000001000001010101000101
101011111010101010111011101
101000100010100010100000001
101010111011101110111111101
101010000010000000100000001
101011101010111011101011111
100010001010001000101000001
111111111111111111111111111
