111111111111111111111111111
101010000000001010000010001
101011111110101010111010101
100010001000101000001010101
111011101010111111111010101
101010000010100000000010101
101010111011111010101010111
100000100000100010101010001
101110111110111011111010101
100010100000001000101010101
101010111110101011101011101
101010100000101000100010001
111011101110101111101010111
101010100010100000001000001
101110111011111111101011101
100000001010100000001000101
111010111010111110111011101
101010100010000010100010101
101110111010101111111010101
101010000000101010001000101
101011101111111011101011101
101000000000100010000000101
101110111110101010111111111
100000001000101000000000001
111010101110111010111110101
100010101000001010000010101
111111111111111111111111111
