111111111111111111111111111
101010100010001010000000101
101010111010111011111110101
100000001010100010100000101
111110101010101110111011101
101000100000000000101000101
101111101110101111101011101
101000101000100010000000001
101110111110101111101011111
100000000000100000101000001
111111101011101010101110101
100000001010001010001000101
101010101111101011101110101
101010101010001010000010101
101110111011111111101010101
101000100000000000001010101
111011111110111011101111101
100000100000100010100010001
111010101111101010101111101
100010101000001000100010001
111011101010101010101111101
100000101010101010100010101
111010111110101110101110101
100010101000101010101010001
111011101110101011101011101
100010000000100000100000101
111111111111111111111111111
