111111111111111111111111111
100000100010001000100000101
101111111010101011101110101
100000100010100010000010101
101110111010111010111011101
100010000010001000100000001
101111111110111111111110111
100010000000001010000010001
111011111011101010101011101
101010100010001000101010001
101010101010111011101010111
100000001010001010001000001
111111111111111011111111111
100010000000101000100000101
111010101011101011101110101
100000101000100000101000101
111110101011101011101011101
100000101000101000101000001
111010111110111011111110111
100010100010100000100000001
111011111010111110111111101
100000100000001000101000001
101111111111101110101011111
101000101000101010100000001
101010101011101010101010101
100010000000100000001010101
111111111111111111111111111
