111111111111111111111111111
100000000000000000000000001
101111101111101010111010111
101000000000101010100010001
101110111110111110111111101
100010000010100000100000001
101111101110111111111010101
100000100010000010000010101
111110111011101110101110101
100000001000100010101000101
111010111111111110111011101
100010000000000010100000101
101010101011101010111010111
101010101000101010100010001
101110101011111111111010101
101000101000001000000010101
101011101111111111101110111
101010000000001000001000001
111011111110111010111110101
100000100000001010100000101
111111101111111111111010101
100000000000000000001010101
111010111011111110101011101
100010100010000000101000101
111011101110111110101111101
100010000010000010100010001
111111111111111111111111111
