111111111111111111111111111
100010101010000000001010101
111010101011101110111010101
101000101010101010001010001
101011101010111010111011101
100000100010001000000000101
111110111010111111111011101
101000100000101010100000001
101110111010101010101110111
100000000010100010000010101
111111101011101111111110101
101000001010000010000000101
101111101011101111101110101
101010101000001000101000001
101010111011101011111011101
100000000010000000000010001
101010111110101111101111101
101010101000101010001000001
111111101011101011101110101
100000000000101000001000101
111110101011111011101011101
101000101000100010001010001
101110111111111011101111101
100000001000000010000000101
101010101110111011101011101
101010101000100010001000101
111111111111111111111111111
