111111111111111111111111111
100000000000000000000000001
101010101011111011111110101
101010101010000000000010101
101011111111101111101011101
101000000010000000101000101
101111111011111010111010111
100010000000001010100010001
101110111111111011101010111
100010100000000000101010001
101111101010111011101011101
100000101010100010001000101
101010111010111011101110111
101010100010001010001000001
101010111011101111101111101
101010100010000010000000101
101010111110111110111110101
101010100000100000000010101
101010101110111011111010101
101010101000001000001010101
101011111011111011111111101
101010000000100010000000001
101110111010101011101011101
100010100010101010001000101
111110111010111010111010101
100000100010100010100010101
111111111111111111111111111
