111111111111111111111111111
101010100010000000001000101
101010101110111111101110101
100000101010001000101000101
111010101010111010111010101
100010001000000010001010001
111111101011111011111110111
101010000000100010000010001
101011111011101111111010101
100000001010000000101010101
111011101011111111101010101
100000100010000010001000101
101111101011101110111011111
101000101000100010100010001
111110111110101110101111101
100000000000001000000000001
101111101110101011111011101
101010101010100000001000101
111010101010111110101011111
100000001000001000101000001
111110111110111110111011101
100000100000101010101010101
111010111010101011101110111
100010101010100000100000001
111011101010101110101111111
100010000010001000000000001
111111111111111111111111111
