111111111111111111111111111
101010001000001010000000001
101011101011111011101111101
100010001000000000000010001
111010111110101111101011101
101010000000100000101010001
101011111010111111111011111
101000101010100010000000001
101110101110111010101010101
100000101010100010101010101
101011101010111010111111101
101000000010001000000000101
101111111111101110111011101
100000101000100010100010001
111011101110111110111111101
101000100000100000000000101
101011101110101111111111111
100010100010101010000000001
101110101110101010101111101
101000000010100000100010001
101010111110101110111110111
100010100000001000000010001
111110101110111110111011111
100000101000100010100010001
101011111011101010111110111
101000001000101000000000001
111111111111111111111111111
