111111111111111111111111111
100010001000000010101000001
101010111011101010101011111
101010001010001010101000001
111010111011111110101110101
101010001000000010101000101
101011101011111010101010101
100010101010000000100010101
111010101010111010101111111
100010001010100010000000001
101111101111101111111111101
100010001010001000100000101
111010111010111110111011101
100010001010000000101000001
101110101010111110101110101
100010101000001010100000101
101011101010111010111011111
101000000010001000100000001
111111111111111111111011111
101010001010100000001000001
101011101010101110111111101
101010100000001000100010001
101010101110101110101010111
100000001000101000101000101
101011111110101011101010101
101000001000101000001010001
111111111111111111111111111
