111111111111111111111111111
100000100000001010000000001
111010101011101010111111101
100010101010001000000010001
101110101010111111111110111
100010101010100000000010001
111010111010111011111011101
100010000010100010001010001
101111111110101010111010111
100000100000001010100010001
111110111111111110101110101
100010000000000000100010101
101111111111111111111010101
101000000010000000100010101
101011101010111110101111101
101010001010101000100000101
101010111010101010111110101
100010001010001010100000101
101111101111101011101111101
101000100000101000001000001
101010111011101111111010101
101010101000101000001010101
101010101110101111101010101
101010001010001000100010101
101011101011111010111110101
100010000000000010000000101
111111111111111111111111111
