111111111111111111111111111
100010000010100000100000101
111011101110111110111011101
100000000000101010100010101
111110101111101010111010101
101010100000100000000010101
101011101111111110101110101
101010000000100010101000001
101011101110111011101011101
100000001000001000101010101
101110111110111011101010111
101000100000001000000010001
101010111111101011101010111
101010100010000010001000101
101111101110101110111110101
101000001000100010100000001
101111101111101110101111101
101010000000000010101000001
111011101011101110101110101
100010001000100010101000101
111011111011111011111110111
101000000000001010000000001
101010111011101010111110111
100010100000101010100000001
101011111010101110101110111
101000001010100010101000001
111111111111111111111111111
