111111111111111111111111111
100000100000000010001010001
101110111111111010101010101
100010000000000010101000101
101011111111111110111010101
101000000010000000000010101
101111111010111111111110101
101010000010100010000010101
101010111111101110111010101
101000001000000000100010101
111011101011111111101110101
100000101010001000100010101
101110101010101110111011101
100010101010100010000010001
111110101010111010111110111
101000100010100010100010101
101011111110101111101010101
101000000010101000001010101
101111111010111011101110101
100000000010000010000000101
101111101111111011111111101
101000101000001010001000001
101010101011101010101010111
101010101000100010100010101
101010101110101110111110101
100010100000100000100000001
111111111111111111111111111
