111111111111111111111111111
101000000000100000000000101
101011111110111111111010101
100000001000100000001010001
111111111011101111101011111
101000001000001010001010001
101110101111111010111010101
101000101010000000000000101
101011101010111111101111101
100010001000101000101010001
111110111111101010101010111
100000100010000010001010001
101111101010111111111010111
100000101010100010001010001
111110111010101010101011101
101000100000101000100010001
101010101111101111111110111
101010100000100000100000101
101010111110111110101110101
100010001010100010001000101
101111101010111010111011101
100010101010100010001010001
111010101010101111101110101
100010101000101010001000101
101110101011101010101011101
100000100000001000100010001
111111111111111111111111111
