111111111111111111111111111
100000000000000000000000001
111011111111101011101011101
100000000010001010001010001
101111101010101010101011101
100000101010101010101000101
101011111111101011111010111
101000000000101000100010001
101111111110111010101010111
100000001000100010101010001
101010111111111110111110101
101010001000000000001000101
101011111010101111111010111
101000001010100010000010001
101111111011111111111010101
101000000000100000000010101
111011111011101111111110101
100010000000100000000010101
101010111110101110111011101
101010100000100010100010001
101011101110101011101110101
101000100010101000101000101
101010111011101011111111101
101010100010001000001000001
111111101111101111111110111
100000000000100000001000001
111111111111111111111111111
