111111111111111111111111111
100000001000100010000010001
111010111010101010101010101
100010000010001000101010101
101111111111111111111110111
100010001000101010000010101
101110101110101010111110101
100010101000001010000010001
101010111110101010101111101
101010000000101010100010001
111011111110111011101110111
101010101000000010000010001
101010101011101011101110111
100000000000101010101010101
111111111111111010101010101
100000000010000010000010001
111011111110101111111011101
101010001010100010000010001
101011101010111011111011101
100000000000100010000010001
101111111011101110111111101
101010000010100000100010001
101011101110101010101110111
101010100010001010000000001
101010101011111010111010111
101000001010000010100010001
111111111111111111111111111
