111111111111111111111111111111111111111111111111111
101000100010100000101000100000100010000000001000001
101010101010101011101010111011101011111011111011111
100010101000001000101010100000101010000010001000001
101010101111101010101110101111101011101110101110101
101010000010001010000000100000101000000010101010101
111111111111111110111111111010101010111011101010101
100000001000100000001000100010101010101000001000101
111110111010101010111011111010101010101010111110111
101000001010001010001000000010101010001010000000001
101010111111101111111110111011111111111111111011111
100010001000001010000000100000100010100010101000001
111011101111101010111011101110111010101010101110101
100010001000101000001000100010101000101000101000101
101110111011101111101011111011101010101111101110101
100010000000100000001000100000100010100000001000101
111011111110101011111110101111111110111110111110101
100000001000001000001000100000100000000000000000101
111111111011111111111010101110111110101111111011101
100010000010101000001010101000100000100000001000101
101011101010101110111110111110111111111111111011111
101000001000001000101000100000101010001000100000101
111011111110111110101110111011101010111110101111101
100010001000101000001000100010101010001000100000101
101011101011101011111011111010101010111110101111101
101010001000101010101000100000100010001000101010101
111010101110101010101110101111101010101011101010101
100010100000000000001000100000101000101000000000001
111111101111111111111111111111101010111011111111101
100010100000000010000010001000101010000000000000101
101110111110101110111011101010111111101111111111111
100010100000100010001000000010101000000010001000001
101110101010111010111110111111101110111110111011101
100010101010101010000010001010101000100010001000101
101010111110101011101110101010101110101111101011101
101000000000100010000010100000101000000000001000101
101111111111111110111110111110101011101110111111101
100000001000000010000010100000101000100010000000101
111010111010101010111011111011101011101111101011101
100010001010101010101010000000100000100010001000001
111010111110111110101011111110101111101111111011101
100010101000000010100010000000001000000000001000101
101110101011101010111110101010111111111110111111111
101010001010101000100010101010100010000010100010101
101010111010101010101110101111101110101010101110101
100010000010001010000010100000101010101010000010101
111011111111111111111111111111101011111011101110101
100010001000000010101000100000100010101010000000101
101111101010101110101010101110101110101010101110101
100000000010100000000010000010100000000000100010001
111111111111111111111111111111111111111111111111111
