111111111111111111111111111111111111111111111111111
100000001000101000101000100000001010100010000000001
101011101010101110101110101111111010101011101111111
101010000010001000101000100010001010001010000000101
101111111011101011101110111010111010111011101011101
101000000000100000001000100010001010001000001000001
101011111011101111111110111010111011111010111011101
101010000010100000001000000000001010101010101000101
101010111010101111111110111011111010101010101011101
101010001000101000001000100000001000000010001000101
101010101011101110101010111011111011111111111011111
101010101000100000101010100000001010101010000000101
101011111111111111101111111111101010101010111011101
101010101000101010000000100000001010001000101000001
101010101010101011101010101011101010101010101011101
101000000010100000001010001010000010100010100000101
111111111111111111111111111111111111111111111110111
100000100000000000100000000000000000100000000000101
111011101110111011111111111111101111111011111011101
101000101000101000100010100010000000101000100000101
101010101011101110101010111010111010101110111010101
100010101000101000101000100010100010100000100010101
101111101011101011101111101011111011111011111110101
100000101000100000100000101010000010100000100000001
111011101110111111101110101110111010101111111111111
100000101000000000100010000000001000101000101010001
101010101111111111101110111011101111101011101011101
101010000010101000100010100010000000101000000010001
111110101010101010111110111111101111101110111011101
100000101010000010100000000010000000101010001010001
111011101011101110101110101011101010101011101010111
101000101000000010100010101010001010000000001000001
101010101010101010111111111111111110111011111011101
100010101010101010100010000000100010100000001010001
101110111011111111111011111110111010111111111011111
100010100000100000100010001000100000100010100000001
111110101010101110111010101011111010101110101010101
100000101010100010100010100000101010100000001010101
111110101111101111101111111011101010111111101111111
100000100010000000000010001000000010100000000010001
111110111010111011111011101110111010111011111110101
100000100000100000100000000000100010100000100010101
101111111111111111111111101111111111111110111011101
101000100000001000101000101000100010100010000010101
101011101110101010101010101110111010101110101110101
101000100010100010100010101000000010100000100010001
101011101110101111111110101011111010111110111010111
100000100010100010000000001000100000100000100010001
101111101010111010101110101011111010111011111111101
100000101010100000101000100000100010100000000000001
111111111111111111111111111111111111111111111111111
