111111111111111111111111111111111111111111111111111
100010100000000000000000000000000000000000000000001
101110111111111111111111111111111011111111111111111
100000100000101010000010100010001010000000100000001
111011111011101011101010111010111011111110101111101
100010100010100000001000100010001010100000101000001
111010111010101110111110111010101010111110101010101
101000100000101000101010100000101000001000101010101
101010111011101011101010111110111010101011101111111
100010100010101000001000100010001010100000000000001
111011111010111011111111111010111010111110111111101
101010100000101000000000100010001010100000100000001
101010111011101011111011111010111011111111111111101
100000100010101010001010000000001000000000100000001
111011101110101010101010111011111110101110101010101
100000100010101000101000100010001000101000101010101
111011111010101111101111101010101110101011101111101
100000100000101010001000101000101000101000100000101
101010111110101010111011111110111111111111101111111
101010100000100010101000101010001010000010100000001
111110101110101010101010101010101010111010101010101
100000100010101000000010100000100000001000001010101
111011101111111111111111111111111011111111111111111
100000100000101000100000100000101000101000000000101
111110111011101110111010101110101011101010101110101
100000100000100000000010101000100000100010101000001
111011101011101011111010101011101110111011111111101
100010101000101010100010001000101010000010001000001
101110111011101010101111101011101010101110101011111
100010101000101000100000101000101000100010101000001
101110101010111111101111111111101110101110111110111
100000100010101010000000100000101000100000001000001
111011111110101011101110111110101110111011111011101
100000100000100010001000100010101000100000001000101
101011111110101111101110101110111111111110111111111
101000000000100010001010100000100010001010000000101
101110111011101110111010111110101110111010111011101
101000100010100010001000000000100000001010001000101
101111101010101111101111111110111010111010111011101
100000101010000000101000000000100010001000001000101
101011101110101110101010101010111010111010111110101
101000100000100010001010101010000010000010001000001
111110111111111111101111111111111111111111111111111
100000100000101010000010101000000000000000001000001
101011101110101011111010101010111110101110111010111
101000101000000010100010001010101010101010000010001
101111101011101110101110111110101010101010101010111
100000101000100000000000000000100000101000101010001
111110101111111111111111111111111111111111111111111
100000100000000000000000000000000000000000000000001
111111111111111111111111111111111111111111111111111
