111111111111111111111111111111111111111111111111111
100000101000001010000000000010101000101000001000101
101110101111101010111111111110101011101110111011101
100010000010001010100000001010000000101000000000001
111010101010101010101010101010111110101010111011101
100010101000101010001010101010001000001010001000101
111111101111111010101110111011101111101011111111101
100010001000000010100010000000001000101000001000001
111011101011101010111111101010111110101111101111111
100010000010001010100000101010000000101010001000101
111011101011101010111010101011111110111011101011101
100000101010001010100010001010000000000000000000001
111010101010111011111111111111101111111111111111111
100010001010001010101000000000100010000000000000001
111111111111101110101011101010101111111111111011111
100000001000000010000000101010000010000000101000001
101111111010111010101111111010101110111010101010101
100000001010001010100000100010100000100010000010101
101111111111101011111111101111111110111110101110111
100000101000001010001010000010001010101000101000001
111010101110111011101011111010101010101110101011101
100010001000001010100000000010100010100000101010001
101010101010111010101011101010111111111011111111111
101010101010001010001010001010000010000010000000001
111110101011111011101011101110101111111011111110111
100000100000001010001010000010100010100010100010101
111111111111101010101010101010111110111010101110101
100000000000001010101010101000000010100000000000101
111111101111111110111010111111111110111010111010101
100000000000000010001010100000001010000010100010101
111111111111101111101010101110111010111111101111101
100000000000000010001010000010000010000010000000001
111111111011111111111111101111111111111111111111111
100000000000000010000000001010100000001010101010001
111111101111111111101111111010101111111010101011101
100000100010001010000000001010100000001000001000101
101011101111101011111110111010111110111011111010101
101000000010000010000010001010100000001010001010001
101010111011101010101010101010101111101010111111101
101010100000001010101000100010001010001000001010001
111111101111111110111111111010101010111010111011101
100010000000100010101000001000100010001010000000001
111010111010111010101011101010101111111011111111111
101000001010000010001010001010100000001000001000001
101011101110111011101011101010101111101010111110111
100010001000100010000010001010100010001010001000001
111010111111111010111111111010101011101010111110111
100010001000000010101000001010101010001010000010101
101010101011111010101110101010111111101111101010101
101010101000100000000000101010100000000000001000001
111111111111111111111111111111111111111111111111111
