111111111111111111111111111111111111111111111111111
101010100000101000000000001000000000101010001010001
101010111011101110111011111110111111101011101010101
101010001010101000100000001000001010000000100010101
101010111010101110111111111011101010111111101110111
100000001010000010101010100000101000100010000010001
111110111010111010101010111011111011101111111010111
100010100010101010000010001000101010100010000010101
111010101110101110111110111011101010101110111110101
100000000000001010001000000000000010000000101000001
111110111011111010111010111011111110101011101110111
101000001010001010001010100010101010101000000000001
101111111010111010111111111010101010111011101010111
100010101010100000000000100010001000101010101010001
101110101010111010111111111010111110101110111111111
101000001010100010101010101010101010000000001010001
101111101010101011101010101010101010111110101010111
101000001000001000001000000000000000001010101000101
101110111011111111111011101110101011101011111011101
100000100000101010001010100010101000100000000000001
111011101011101010101010101110111011101010101011111
100000001010001000100000101000001000101010101010001
111111101111101011111111111110101011111011101110111
101010100000000000000000000010101000001010000000101
101010101011111111101111111111111111111111111011101
101000101000001000100010100010000000000010100000001
101110101011111011111110101110111010111110111111101
100010001000000000001000101000101010100000100000101
111010111111111011101110101110101111111011101111111
100000000010101010101000001000101000101000101010001
101110101010101110111111101011101110101011101010111
101000101000000000000000000000000010000000000000101
101110111010111011111110111010111110111110101111101
101000001010001000001010001010000000001000100000101
111010111111101111111011101110111011101011101011101
100010000000100000100010000010101000101010101010101
111110111110101011101111111110101111111110111110101
100000000010101000000000001000100000000010001010001
111110111010111010111011111010101010101110111010101
100000100010101010001000001010001010101000100010101
111011101011101110111010101110101111111110111010111
100010001010100010101010100010100010001010000000101
111010101110101111101011101011101111101010101010101
100010101000101000100010101000100000000000101010001
101011101110101011111110111010101111101111111011111
101000100000000010001000101010101010000000001000001
111011101010101110111011101111101011101011101110111
100000101010100010000000000010001000101010100010001
111111101011101010111111101111101011111010101110101
100000001000101000000000100010000000100000101000101
111111111111111111111111111111111111111111111111111
