111111111111111111111111111111111111111111111111111
100000000000000000000000000000000000000000000000001
101111111011111010111011111011101011101110101110101
100000001010000010001000100000101010001000101000101
111010111010111010111110101111111110111110111010111
100010001010100010100000100000100000000010001010001
101111101011101110111110101011101011101110111111101
101000001000101000000010101010001010000010001000001
101010111010101110101111101010111111111011111110111
101010001010100010101000001010000000100000000010001
101011111110111011101111101010101110101111111010101
101010000000100000101000001010100010101000000010101
101010101011111110111010101111101111101011101011101
101010101000000010001010100000100000101010001000101
101111101011101010111011101110101010101111101010111
100010001010001010100010000010101010101000001010001
111011111011101011101111101011101111111110101011101
100010000000101000101000001010001000000000101000101
101110101111111011111110111110111111101010101110101
100010101000000000000010100000000000101010101000101
101011111110101010111011111111111110101010101010101
101000001000101010100000000000000010101010101010101
111111111110111110111010101111111011111110111010101
100000000000100000001010100010000010000000100010101
111010111111101111111010101010101010101110101011111
100010100000000010000010101010101010101000101000001
101110111111111010101111111111101111111111111110101
101000000000001010100000100000000000001000000000101
101011111110101011101111111111111010101011111111101
101000100000101000101000000000000010101000000000101
101111101111101011101011101111111110111111101110101
101000000000101010001010000000100000100000000010101
111110101011101011111011101011101010111011101110111
100000101000101010000000101000101010100010001000001
111111101010111011101010101110101010111010101111101
100000001010100010001010100010101010100010100010001
101011111011111111111110101110111110111110111011101
101000100000001000000000100010100000000010100000101
101011101111101111111011101110101111101110111011101
101010001000001000000000101000101000001000001000101
111110101011111010111110111111111110111010111010111
100000101000100010000010000000100000100010100010001
111110111111111110101110101011101010111110111111101
100000000000000010101000101010001010100000000010001
111010101111111011101011101010101010111111101010101
100010100010000000101000101010101010000010001010101
101110101011101111101011111110111111111111111111111
101000101000100000101010000000000000000000000000001
111010111111101010101111101111101111101011101010111
100010000000101010101000000010000000101000101010001
111111111111111111111111111111111111111111111111111
