111111111111111111111111111111111111111111111111111
100000000000000000000000000000000000000000000000001
101010111111111011111111111111111010111110111010101
101010001000000000000000000000001010100000001010101
101011111111101111101111101010111111111011111010111
101000001000001000000010001010100000000000100010001
111011101011101010101011101010111111101111101011101
100000101000101010101010001010100000000000101010001
111111101111101111101011101110111010111011101111101
100000001000001000001010001000100010100000101000001
101111101011101110111011101011101011101010101010111
100010001010001000100000101010001000101010101010001
101111101111111010111111101011111010101011101111101
101000000000001010000010001000001010101000100000101
111110101110101111101011101111101110111111101010111
100000100010100000101010001000001000000000101010001
101111101011101011101110111110111011101010111010101
100010001010001000100010001000100010001010100010101
101110111011101011101110101111101110111010111011111
101000001010001000100010100010000010100010001000001
111010111110101010101110111111111011111011101111111
100010100000101010101000000000100000100000100000001
111110111110101110101111101010101011101111111110111
100000000010100010101000001010101000101000000000001
111010111110111110111111111011101111111011111111111
100010100000100000001000000010000000100000000000001
111010111111111010111011101010111111111011111010111
100010001000000010100000101010000000001000001010001
101010111011111011111011111011111111101110101111101
101010100000001010000000100000000000101000101000001
101111101011101010101110111111111010101010101110101
101000001000101010100010100000000010101010100010101
101110111110111111111110101011101011111011101010101
100010100000000010000000101010001010000010001010101
111011101110111011101011111010111010101011111110101
100010000010001000101010000010001010101010000000101
111011111111101110111111101110101010101010111110111
100000000000100010001000000010101010101010000010001
101010111010111011101010101011111011101111111010111
101010100010100000101010101010000000100010000010001
101111111110101110111010111011111010111110111111111
101000000000101000001010100000001010001000000000001
101010101111111011101010111010101110111111101111111
101010101000000010001010001010100010000000100000001
101110111111111110111010101111101010111010101011101
100010000000001000001010100000101010001010101010001
101110101011111010111010111011111110101010111010101
101000101000100010100010100000000010101010001010101
101011111010101110101110111011111011101010101010101
101000001010101000101000001000100010001010101010101
111111111111111111111111111111111111111111111111111
