111111111111111111111111111111111111111111111111111
100000000000000000000010001000000010000010000010001
101111111011111111101110101011111010111011111010101
100000101000000010001000101000001000100010001000101
111110101111111010111011101011101111101110101111101
100010001000100010001010001000101000100000100000001
111011111011101111101010111110101110101111111111101
100010001000100000100010000010101000101000100010001
101011101110111111111111111010101011111010101110111
101010000000000010000000100010100010000010100010001
101010111111111010101110101110101111111110111010111
101010000000001000101000100010100000000010001010001
101011111111101111101011111010111010111011101011101
101000001000101000001000101000100010001000100010001
101111101011101111111010101111101111101110101110111
100010001000100000001010100000001000101010100000101
111010111110101111101010111111111010101010111011101
100010100010101000101010000000000010101000100010001
101110101110101011101111111111111010111011101110101
100010100010001000100000100000001010001000100010101
111010111011111110111110101111101111101110111011101
101010100010000000100000101000101000100010101000101
101010101110111110101110101011101010111010101010101
101010001000101000100010001010000010101000101010101
101010111010101011101111111010111110101111101010101
100010100010101000001000000010100010100010001010101
111011101110101111111011111110111010101010111010101
100010001000100000001000000000100010001010100010101
101110101011111111101011111111101111111010101110101
101000101000100010001010000000100010001010101000101
101011111010101110111110111110111011101010101011101
100010100010100010100010100010000000100010101000101
111010101110101010101010101111111010111110101110101
100010001000101010101010101000000010000010100010101
101111101011101010101010101011111111111010111010101
100010001010001010001010100010001010001000100010101
111010111011111011111010101110101010111110101010101
100010001000100000100010100010101010100010101010101
101011111110101110101111111110101010101010101010101
101000001000101000100000100010101000101010001010001
111110101011101111101110101011101110101011111111111
100010101000001000001010001000001000101000000010001
101010101111111011111010111110111010111111111010101
101000100000100000100010100010000010001000000010101
101111111110101110111010101011111111101011111010101
100000100010001010001010101000001000001010000010101
111110111011111011101010101111101011101110111011101
101000000010001000101000101000101000100000100010001
101011111111101011101010111010101110111111101110101
100000000000001000001010000010001000000000100000101
111111111111111111111111111111111111111111111111111
