111111111111111111111111111111111111111111111111111
100010000010000000100000001010000010000000000000001
101010111110111110101111101010111010111111111111101
101000000000100000001000100010001010100010001000101
101111111111101111111010111111101010101011101011101
101000000010001000100010000010001010101000101000001
101011111010111010101111101010111010101110101110111
101000101000001010000000101000101010001000100000001
111110101111101111111110101111101010111011111111101
100010001000000010000000100000001010100000101000101
101011111011111010111111111011111010111110101010101
101000001010001000100010000010001000100000100010101
101111101010111111101010111110101111101111111110101
101000101010100000101000100000100010001000000000101
101010101010101110111111101111111010111011101111111
101010100000100010000000100000001010000000101000001
101010111111101011111110111111111011111110101010101
101010001000101000100010100010001000001000101010101
101111101010111110111010101010101011101011111011101
100000000010000000100010101000101010101010000010001
101111111111111110101110101111101010101010111110111
101000100010000010100000001000101000101010000010001
101010101110111011101111111010101110101111111011101
101010100010101000001000001010100010100000001010001
101110111010101111111110101010111010111110111010111
100000100010100000000000101010000010100010001010001
111111111010111011111111111011101110101011101011101
100000001010000010000000001000101000101010101010001
101111101011111111111110101111101011101010101011101
100010100000100000000010101000001010001000100010001
111010111010111110111010101011111010111110111110111
100010000010000000100010101000001010100010100000001
101011111111111110101110101111101010101010101111111
101010000010100000100000100010000010101000100010001
111010111010101111111111111010111110101110111010101
100010001010100010000000101000100000100010001000101
101011101010101010111110101111111011111111101111101
101010001010001000100000100000001010000000000000101
101010111011111111111111101111101110111111111111101
101010001000000000000000001000100010000000000010001
101110111111101111111111111110111011111011111010101
100010001000101000101000000000000010000010001010101
111011101010101010101010111011111110111111101010111
101000100010100010100010001010100000100000001000001
101011111110111110111111111010101111111011111111101
101000001000100010001000000010101000000000100010101
101110101011101111101011111110101011111110101010101
100010101000100010001000000000101010000010101000101
101010101110111010111111111111101010111010101111101
101000100010000010000000000000000000100010100000001
111111111111111111111111111111111111111111111111111
