111111111111111111111111111111111111111111111111111
100010000010000000000000000000000000000000100000001
101010111010111111111110111111101111111110111111101
101000001000100000000000101000001000100010000000001
101111111111101111111111101011111010101011111110111
101000100000101000000000001010000010001000100010101
101010101110101011111110111011111011111011101010101
101010000010100000100000100010001000101010001010001
111011111011101111101111101110101110101010111011101
100010001000001000101010000000100000100010100000101
101110101111111010101010111011111111101110101111101
100000100000001010100010100010001000001000100000101
111111101111101110111010111110101011111011111110101
100000100000100000100010001000101010000000100010101
111110111110111111101111101111101010111111101010101
100000100000000000100000100000100010001000001010101
101111101111111111111111111110111111101011111011101
101000101000001000000010001010000000101010000000001
101010101011101011111010101011111110101011111110111
100010101010101000001010101000001000101000000010101
111110101010101111101010101111101011101111101110101
100000100010100010001000101000100010000000100010101
101111111110111010111010101011111110111110111010101
101000100010001000100010101000100000100010000010101
101010101110101011111010101110101111101111111110101
100010100000100010000010100010100000100000001000001
111110111111111110111111101010101110111111101011111
100000100010100000100010001010001010100000001000001
101111101010101111101110111011111010101011111011101
101000001000100010100010001000001010001000001010001
101111101110111010101011101111101010111111111011111
101000101010001010001010000010000010100010000010001
101010101010111011111011101011111110101011101110101
101010101000100010000000101010001000101000001000101
101010101011101110111110111010101011101111111111101
101010101010001000001000100010101000101000001000001
101010101010111011101011101111101111101011101011101
100010101010001000101000101000100000100010001000101
111110101111101111101111101010111110111110101111101
100000100000001000001000100010001010000010100000001
101111101111111010111010111011101011111011111111101
100010001000100010000010001000101000100000001000101
101011111010101111111111101110101010101111111010101
101000001010100010000010000010100010001010000010001
111111101010111010111110111110111111111010101111111
100010000010000010001000100000100010001000100000101
101011111111111111101010101111101010101111111110101
101000000010000010000010100000001000100010001000101
101011111110111110111011111111111111111010111011101
101000000000000000001000000000000000000010000000001
111111111111111111111111111111111111111111111111111
