111111111111111111111111111111111111111111111111111
100010001000001010100010000010000010001010000000101
101010111011101010101011111011101010111010111111101
101010001000101000101010100010101000000000000010001
101010101110111011101110101110111010111010111110111
101000100010000000100010000000001010001010000000101
111111101010111110101111111010111110111011111011101
100010001000100000000010000010100000001000001000001
111010111011111011111111101111101110111111111110111
101000001010100010101000001000000010100010001000101
101010111110111010101111101011101111101011101010101
100010100010000010100000001010000010101000000010001
101011101110111010111010111110101110111111111110111
101000101010001010000010100000100000100000001000001
101010101011101010101011111110111110111110111110111
101010000010001000101010100000001010100000001000001
101111111110111011101110111011111011111011111111111
101000100000001000100000001010100000000010100010101
101011111111111010111111111010111111101110101010101
100010000010001010000000100010100010000000101000001
111111101010101110111010111010101011111011111010111
100010101000100000101010000010001000100000100010001
111010101010111010101011111110111111111011101011101
100000101010100010001010001000100000001000101010001
101111101010111110101111101110101111101011111010111
101000001010001000101000001000101000100010000010101
101010101111101111111111101010111011101011111010101
100010100010000000001000000010100000001000100010001
111110111011111110111011111110101111101011101011111
101000101010000000100010000010000010001010001000001
101011101111101110111011101111101111111111111010101
100010001000001000000000000010000010000000000010101
101011101110101111111011101111101111111010101011111
101000000010100010000000100000100010000010101000101
111011101111101111101010111111101111111110101110101
101010001000001010101010100010100010100010100010001
101111101110111010111011111010101110111010101111111
100000001010101000001010000000000000000010101000101
111110101010101110111110101111101111101111101011101
100010101000100010000010100000101000000000100010001
101010101011101111111011111110111111101011111010101
101000101000100000000010000010100010101010100000101
111011111011101010111110101011111010101010111110111
100000001000001010000010101000100000101010000010101
101011111111101111111010101111101110101110101010101
101010100000100000100010100000000010101010101000001
101110111011111011111110111010111110101011111110101
101010000010101000001000001010001000000000001010101
101010111010101011111111101111101110101111101011101
100010001000000000000010001000000010101000000000001
111111111111111111111111111111111111111111111111111
