111111111111111111111111111111111111111111111111111
101010000010001000100010001010000000000010101010001
101011111010101110101110111011111011111010101010111
100000101000101000101000101000101000001010000000001
101111101011111110101010101011101011111011101111101
101000001010001000001010100010001010001010101000101
101011111011101111101110101110111011101110101011111
100010101010101010001000001010000010000000000010101
111010101010101011101011101011101110101110111110101
100010101000001000000010100000001000100010000010101
111010101110101111101110111011101011111111101110101
101000101000101010100000001000100010100010000000001
101110101011111010101011101111111110101111111010111
101010100000000000001010000000100000000010000010001
101010101011111111111111111011101110101111111010111
100000001000100010100000101010100010100000001010001
111011101111111010111011101110101111111110111110101
100010001010000010101000000000000000100010001010101
101111101011101010101011101111101111101111111011111
101010000000101010000000100000100000101000000000001
101011101111101110111111101011111011101011111010111
101000000010000000000010101010100000000010101010101
111111101111101011101110111010111010101010101111101
100000001010101010101000101000001010101010000010101
111011101010101110111011101011101110111011101110101
101010000010000000000010100010001010101010001010001
101111101010111011111010111110111011101110111010111
100000101000001000101000001010101010001000001000101
111011101110101110101010101011101010111011111011101
100000100010100010101010100000001000100000000000001
111011101111111111101111111111111010101111101110101
100000000000100010000000100000101010001000100010101
101110111011111010111011101111101011111011101111111
100010001000000000001010000010100000001010001000001
111110101010111111101111101110101110111010101010111
100000101010000010000000000000001000000010100010001
101110111111101110111011101111101110111011111011111
101000000000100010001010000010000010100010100000001
111111101010101010111011111011111111111110111110101
100000001010101010101000001000101000101010000010101
111111101010101111101110111011101010101010111110111
100000001010100000000010100000000010100000001010001
111011101111111011101011111010101011101011101010101
100000100000001000101000100010101000001000100010101
101010101010111011101111111010111011101111101110111
101010101010001000100000100010101010000010101000001
111011111011111011101011101011101110101010111111111
100000100010000010101000101000000010101000101000101
101111101110111110101010111110101110111011101110101
101000000010001000001010001000101000001000000000001
111111111111111111111111111111111111111111111111111
