111111111111111111111111111111111111111111111111111
100000101000100000001000000000100000000000001000101
111110101011111011111010101111111011111110111011101
100000000010000010000010101010001000100000001000101
101010111110111111111011101010101110101011101011101
101010000000000000001010100000101000101000100000101
111110111111101111111010101011111011111111111110101
100010000010101000001010101000100010001000100000001
101110101010111110101010111110101111101011101111101
100000101010000010101010100000100010001000001000101
111011101111101110101010111111101110101010101010111
100010100010000000100000000010000000101010101010001
111010101111111110111011111010111110111111111111101
100010100000001000101000001000100000100000100010101
101110111010101110101110101011111011111011111010101
101010001010100000000010101000101000100000100010001
101010111010101111101111111010101110101110101110101
101000100010101000000000100010100010101000001000101
111011111010111110111111101111101010111011111011111
100010100010100000000010100000001010000000100000001
101010111111111110111110101010101010111110101111101
101000000000000010100010001010101010101010001000001
111011101010111010101011101110101111101010111110101
101010001010100000101000101010100010000000000010101
101111101111111110101011111010101011111011111011111
101000000010001010001000100010101010100000001010001
101111111110111010111111111010111110111010101010111
100000001010000000101010100000000010000010101000101
101011111010111110101010101111101011101011111010101
101000000000000010100000100010001000101000001010101
111111101011101111101011101111111110111110111111101
100000001010001000001000100000101000001010001000001
111111101011111011111111101010101011111011101111101
101000101010001010001000101010100000000000100000001
101110111111101010111011111010111011111110111111111
101010001000000000000000000010100010100000000010001
101010111011111111101111101111101110111111111011101
100000100010000000000010000010001000000010100000001
111010111111111011101010101111101011101110111110111
100010100010000010001010101000100000101000100000001
101110101011111111101111111110111111101110111110101
101000001010000000001000000000000010000000001010101
101111101011111011101110111011101111111011111011101
101000101000000010000000001010101000000000000000101
101010101111101011101111111010101010101110111011101
100010100010001000101010001000101010100010101010001
101111111111111111101010101011111011111111101010111
100000000000100010100000101000101010100000100010001
101010111111111010111011111110101010111110101011111
101010000000001000000000100000100000001000001000001
111111111111111111111111111111111111111111111111111
