111111111111111111111111111111111111111111111111111
101000001010000000100010100010001010101000000000001
101011111011111110111010101111101010101110101111101
100000000010100000101000000000001010100000100010101
111110111110101111101010101010101010101010111110111
100000000000000000101010101010101010001010100010001
111111101111111011101010111111111010111011101111101
100010100010000000001010101010001000001010101000001
101110111110111110111110101010101111111010101110111
100010001010100000100000000010101000100000001000101
101110101011101110101111101110101110111011111010101
101000100000101000001000101010100010001000001010101
101111111010101110111110101010111110111110111110101
100010001010000010100000100000101000100010000010101
111011101110111011111011111011101110101111101110101
100010001000100000100000101000100010000000100000001
111011101111111110101110101111111010111111111011111
100000100000001010000010000000001000001000001000101
111110101110111010101111101110111011111111101010101
101000001010000010101000101000001010001000001010001
101011111011101010101011101110111010111111101011101
100010001000001010100000101000100000001010100010001
101010101111101010111011111110101111101010111011111
101000101000001000001000000010100000101010100000101
101110101011111110111110111111111010111010111011101
100010101010100000001000000010000010001000001000101
111111101110101011111111101110111011111111101110101
100000000000101010001010000000100000101000000000101
101111111111101110111010111111111110101010101011101
101010001000101010000000001010100010001010101000001
101011101010101011101111101010101011111011111011101
101000000010001010101000101000101000000010000010001
101010111111101010111110111011101111111111111011101
101010001010100000000000100000001010100010001010001
111111101010101011101111111111101010101010111011111
101000000010001010000000101000101000101010000000101
101010111111111011111011101011111011101110111010101
100010100000000000001010100010100010001010100010001
101110111110111110111010101110101011101011101110111
101000001010101000001010100010001000100000001000101
101110111010101111101110111010111110101111101111101
101010000010100010001000000010001000100000101000001
111011101011111011101010101011111110101111111011101
100000001010000010100010101010000000000010101000101
111010111011101010111011111010101010111110101011111
101010100010001000100010000010101010000000000000001
101011111111111010101011111010101011111010111111101
100000000010101010001000100010101000001010001010101
101010111110101110111010111010101110111110101010111
101010000000001000100010100000101000100000100000001
111111111111111111111111111111111111111111111111111
