111111111111111111111111111111111111111111111111111
100000000000000000000000000000000000000000000000001
101011101111111011111111101011101111101111111110111
101010001000000000000000101010000000100010000000001
111011111111111111101011101010111110111110111011101
100000000010000000001010001010100000100000001010001
101011101111101111101110111010101011111111101010101
101010000010001000001000100010101000100000001010101
111110101111101111101111111111101110101111111010111
100000101000000000100000100000000010101000000010001
111011111010111011101111111011101011111111101011111
100010000010100000101000000000101000000000101000001
101110101110101011111110111010101010111110101011101
100010101000101000100000100010101010000010101010001
101010111110111110111010101111101111111010111011111
101010100000001000100010100000100000100010100000001
101111111011101111101111111110111010101011111011101
100000001010000000100000001000100010101000001010001
111110101111111110101010101110111011111010111110111
100000101000000000101010100010001000100010100000001
101111101111101110101110111111111110101111111010101
100010000010000010101000000000001000101000000010101
111011111011111011111111101010101110111110111010101
100000100010000010000000001010100010000010001010101
101010111011101111111111111010111110111010111110101
101010001000100000000000001010100000001010000010101
111011111010111011111010111011101110111011111111101
100000100010001000001010001010000010100000000000101
101111101010111111111111101011111011111111111011111
101000001010000000000010001010000000000000100000001
101110111111111111101111101010101111101110101110111
101000100000000000000000101010101000000010101000001
111010111110101111111111101010101110101111101010101
100010000010100000001000001010101000100000101010101
101111101011101110111011111110111110101011101111101
100000101010000010001000000010000010101000101000001
101011101111101111111111101010101010111010101011111
101000100010000000000000101010101010100010101000001
101111111110111110101011111011101011101010111110111
101000000000001000101010000010001000101010100000001
101010101010101010101110101010101010101011101110111
101010101010101010101000101010101010101010000010001
101011111111101010101010111111111011111111101110101
101000100000001010101010000000100000000000101000101
101011111011101111111010111111101111101111111011111
101010000000100000100010001000001000001000000000001
101110101111101110101010111110111010111011101010101
100010100010001000101010100000001010001000101010101
111011101110101110101010101011111111111010111111101
100000101000100010101010101000000010000010100000001
111111111111111111111111111111111111111111111111111
