111111111111111111111111111111111111111111111111111
100010000010001000101000100010000000001000100000101
101011101010111011101110101010101010101011101111101
101010001010000000100000101010101010100000001000001
101110111010101110101110101011101110111110101011101
100000001000101000001000001010001000001000100000101
111111111111111111111011111111101111111111111111111
100000100010001000001010100010000000101000000010001
101110111010101111101010101010111110101010101010101
101010100000101000001010001010001000001010101000101
101010111011101011111010111010101011111010101011111
101000100000101010001000001010101000000010101000001
101110101110101010111011111111111011111111111111111
101000101000100000100000000010101010000010001000001
101011101111101010101110111110101011111010101110101
101000000000101010001000000010100010101010101000101
111111111110111111111111111110111010101010101011111
101010001000000010000010001010000000000000100000001
101011101011101110101010111010101111111010111110111
100010001000100000101000000010100010000010100000001
111010101111111110111111111111111110111111111011101
100010101000101000001000000010000010101000100010001
101011101011101010101010101010101110101011101110111
101010001000000010100010101010100000000010100010001
101110111011111011111010111110111110111010111111101
100010101000100000100010000010000010001000101010001
101110101110101110101111101011101111111111101010111
101010001000101000100010001010101000000000100000001
101010111111111110111011101110101011101111111110111
100010001000000000100010000010001000100010101000001
111011101111111110111111111110111011101110101110101
100010001010000000100000100010000000100000101000101
111010101011111011101110111011111111101111101110101
100010100010000010101010000010000000000000100000101
101110111010111010101010101111111110111111111111111
100000001010001010100010100000000010100010001000101
111011101011101110111010101110101010111010111010101
100010001010000000100010100010101000100010001010001
101111101011101010111010111011101111101110111011111
100010001000001010000010100010100000100010101000001
111011111111111111111111111110101010101110101111101
101010100000101010101010000010001010100010000010001
101010111011101010101011101010111110111010111010101
100000000000101000000000001010100000000010001000101
101110111011101110111111101011111110111111101111101
101010100010101000101000001010100000001010001010001
101010111010101010101110111110111110101011101010111
101000100000000010001000000010001000100000001000001
111111111110111111111111111110101010101010101010111
100000000000000000000000000010100010101010101010001
111111111111111111111111111111111111111111111111111
