111111111111111111111111111111111111111111111111111
100000000000100010001000001000000000100000100010001
111111111110101011101011101011111110101110111011101
100000001000101000001000100010001000101000100000001
101111101011101110111010111010101011101111101111111
100010000010001000100010001010101000001000000000001
111110111010111111101111101011101111111011101111101
100010101010001000001010001000100000000010001000001
101010101011101011111010111110111110111110111011111
101000101010001000001000100010000010101000001000001
101110101010111111101011101011101010101011111110101
101000101010001000001010001000101000100010000000101
101111101011101010111110111110111110111111111111101
100010001000100010100000100010000010100000100010101
111010111110111011101111101011111010101110101010101
100010000010001010001000101000001000101010001010001
101111101011101110111110101111101110101011111011101
100000101000100010000000100000101010001010001010001
111110101111111010111111111110101011111010101010111
100010100010000010001000100000100000001000100010001
101011101010111111101010111011111011101110111111101
101000001000100010101010000010001000101000100010001
101111111011101010101011111110101111101011101011111
101000100010001000001000100000101000000010001000001
101010101110111011101111101110111011111010111111101
100010100010001010101000100010000010100010001000101
111110101111101010101010111111111110101111111010101
100010101000001010001010000010000010100000000010001
101010101011111010111011101010111010111111111111101
101010101010001010100010001000101000000010001000101
101110101010101010101110111111101011111010101010101
100010100010101010101000000010001000100010101010101
111010111110101010101111111110101110111010101110101
100010000010100010100010001000100010001010100010001
101111111110111011101010101011111011101110111011111
100000100000101000101000100010001010100000101000001
111110101011101110111110111110101010111110101111101
100000001010001010100010000010101010000010100010001
101111111010101010101011111110101010101110101010111
100000100010100010001000100010100010101000101010101
101111101111101111111110101010101111101011111010101
101000100000001000001000001010100010001010000010101
101010101111111011111011111010111010101010101111101
100010101000001000100010001000101000101000100000101
111110101110101010101010111011101111111111111010101
101000100000100010101010001010000000000000100010001
101011111111101110101111101010111111111111101011101
101010000000100010100000101000100000100010001000101
101010111111111010111110101111101110101010111110101
100010000000000010000010001000000010001000100000101
111111111111111111111111111111111111111111111111111
