111111111111111111111111111111111111111111111111111
100000000000000000000000000000000000000000000000001
101010111011111011111011101110111011111110111111111
101010001010000000001000100010001000100000000000001
111010111011111011101111111110111011111011111110101
100010001000100010000000000010100010000000100000101
101010111011101110101011111011101010101110101111111
101010100010000010101000100000101010101000100000001
111011111011111011101110111010101010101111111110111
100000100000001010001000100010101010100000001000001
101011111011101110111011101010101011101111101010101
101010000000101000001010001010101000100000101010101
101110101111111011101011101010111111111011111011101
100010100000001010001010001010000000001000100010001
101111111111111110111111101010101011101011111110101
100000000000000010100000001010101010001000000010101
101111111011101010111011101010111110101011111111101
100000001010001010100000101010100000101000000010001
111011101110101011101010101110111010101011101010101
100000101000101010001010101000001010101010001010101
101011101110101011101010111011111110101110111110101
101010000010101000101010001000000010100010100000101
101010111010111011101011111110101010111111101011111
101010100010100000101010000000101010000010001000001
101111101011101111111010111011101011101111101011101
100010001000100000001010100000101010001000001010001
101010101011101010111111101010101011101110111110101
101010101000101010000000101010101010001000001000101
111011111010111111111110111011101010111010111010101
100000001010100000000000001010001010001010100010101
101010101110101110111111101011101111101110111011111
101010100010101000100000001000101000001000001000001
101111111110111111101110111011101111101111111110101
101000000000000010001000001010000000100010000000101
111011101011101010101010101010111010101011101010101
100010001000101010101010101010001010101010001010101
111110101011101010101011101011101111101111101110111
100000101000101010101000101000100010000010000010001
101010111110101110111111101011101011111111101111111
101010000010100010100000001000101000100000000000001
101010111110101011101010111110111110101110111011111
101010000010101010001010100000100000101000100000001
101110111110111110111011111110101011101111111110101
101000001000001000100000001000101010000010000000101
101010111111101011111110111110101110111111101110101
101010001000001000000010001000101000100000000010101
111011111111111011111010111010111011101111101010111
100000000000100000001010100010001010000000101010001
101110111011101011111011111110111010111010111110101
100010001000101000001000001000001010001010001000101
111111111111111111111111111111111111111111111111111
