111111111111111111111111111111111111111111111111111
100000000010000000100000100010000010000000000000001
101011111010111110101110101011101010111111101111111
101010000010000010001010101000101000101000001000001
101011111111111011111010101110101111101010111011101
101000000010000010000000001010100000001010100000101
101111111010101111101111111010111111111010101111101
101000001010101000100010001010001000001010101000001
101011101010111010111111101011101011101011101011111
101010000010000010000010001010001010001000001000001
101011111011111111111010111010111011101111111111101
101000101000000010000010100010001000101000000000001
111110101111111010111010101111101110101011111111101
100000100000100010100010100000100010101000000010101
101111101011101110111110101011111010101110111010101
101000001000001010000000101000001000100010100010101
101110111111111011111111111110101111111010101110101
100010000010000000100000000010100000001010100010001
111011111011101110101011111011111110101011111010111
100010001010001010101000100010000000101010000010101
101110101010111010111110101110111110111010111110101
101000101000100000000000100010000010100010101000101
101011101111111110111111111011111010101110101011101
101000100010000010100000100010000010101000101000001
101110111010111010101110101110111110101011101111101
100010100010101010100010100000100010100010000000101
101010101110101011101110111111101010111110111110101
101010100010101000001000100000001010100010001010001
101110111010101111111011111110101110101011101011111
100010001000100000001000000010100010101000101000001
111011101111101111101111111011111010101110101011101
100000101000000010101000000010001010101010101010101
101111101011111010101011111110101010101010101010101
101000001000100010001010100000100010101000101000101
101011111111101110111010101110111110101111101111101
100010000010001010101010000010000000100000100000101
101111101010111010101010111111101111111110111110101
101000001000100000101010001000100000001000000010101
101011111111101111101011111010111111101011101110101
100010000000101000001000100010100000100010001000101
111110101110101111101110101110101011111110111011101
100000101000100000000010001000101010000000101010001
101111101110111111111011111011111010111110101010101
100000100010001000001000101000001000100010001000101
111110111011101010111110101111101111101011111111101
100000101000100010100010000000100000001000000000001
101111101110101111101011111110111111111111111111111
100010001000101000001000000010100000001000000010001
111010101011111011111111111010111011101011111011101
100000101000000000000000001000000010000010000000001
111111111111111111111111111111111111111111111111111
