111111111111111111111111111111111111111111111111111
101000000010101000001000001000100000001010000010001
101110101110101011111110111110101011101010101110111
100010100000101000100010000000101010100000101000001
111010101111101110101110101111111010111011111010111
101000100000000000101000101010000000001010000010101
101010111011101110101010101011111111101111111110101
100010101010100010100010100010000010000010001010001
101011101010101110101110111010111110111110111010111
101000100000101000101010001000101000101010101000101
101110101111111011101011111111101010101010101110101
101010101010001010000000100000100010000000100010001
101011111010101010101110101111101110101111111011101
100010000000101010100010100010000010100010000010001
111010111111111111101110101110111111111010101111101
100000000000000000101010000000001000100000101000001
111110111011111110101010111111101011111111101110101
100000100000100010101000000010001000001010100000101
111111111011101110111011111111111010111010101011101
100000001010100000001000001000001010001000001000101
111111101010111110111011111011101110111011101011111
100000000010001010000000000000100010100010101000101
111010111010111011111111101110111010111110111011101
101010001010000010000010001010001010100000001010101
101110111110101011101011101011101110101111111010101
100000101000101000001000100000100000100010001000101
101111101011111010111010101110101111101110111110101
101000000010101010001010101000100010000010000010101
111110111110101011111111111011111011101011111011101
100000001010000010101000000000001000101010000000001
101111111011111010101110111010111111101110111110111
100000000000001000001000101010000000000000000010001
101111111110111111101110101011101111111010111110111
101000100010001010100000001000100000001010100000001
111110111010111010101111111110111111101111101010101
100010100000000000101000101010100000000010101010101
101010111111101111111010101011111110111110101111101
101000100010001000001010000010100000001000101000101
101011101111101110101110111110101111101110111110101
101000000010100010100000101000001000001000100010101
111111101110101110111011101011101110101110101110111
100000100000001000001000000010000010100000000000001
101110101011111110111111101110101111111011111111111
100010101010000000000010000010101010000000000000101
111011101111111011111110101111101010101110101111101
101000000010000010100000100000101010101000100000101
101110111111111110111011111110111011111110111011101
100000000000001000000000100000000000100000100000001
111011111011111110111111101011101011111011111010111
100010000000001000000010001010001000001000001010001
111111111111111111111111111111111111111111111111111
