111111111111111111111111111111111111111111111111111
101000100000001000100000001000101000000000101000001
101110111110111011111010101110101111111110101011101
100000100000001000000010100000101000001000001010101
111110101011101111101111111011101010111110101110101
101000001000100000101000101000000010000000100000001
101111111011101011111011101111101110111011101111111
101000000010001000000000101000101000001000100000001
101010111111101111101110101110101110111110111011101
100010000010001000001000001000101010100000101010101
111011101111101011111010111011111011101110101110111
100010001010001010001010001000100010001000000000101
101111101011101110101010111010101010111110111011101
101000000010101010101010000010101010001000100000001
101111101110101011101111111010111010101011111110111
101000100010001000101000100010100000101000001010001
111011111111101110101011111011111110111010111011101
100000101000100010000010001000001010100010000010001
111110101110111111101110111011101010111010101110111
100000101000000010101010000000101010100010100010101
101110101110101110101010111111111011101011101111101
100010001010101010100000001010000010101010001000001
111010111011101010101010111010101010101110101011111
100010000010100000101010000010101000101010100000001
101110111010111110101011101010101110111010111010111
100010100000000010001000101000100010000010001010001
111010111011101011111011111011111110111011111010111
100010001000101000001000100000001000100000000010101
101110111010111111101110101111111110101010101011101
101000001010000010001010100010000010101010101000101
111011101111101011101011111111101110111011101110101
101010101000101010000010000000001000100000100010101
101010111110111111101110101011111110111010111011101
101000100000100000100010101000001000101010001000001
101010111011101110111011111110111110101110111111111
100010000010000010001010101000100000000010100000001
101110101111101111111010101110101010101111111010111
100010100010001000001010101000101010100000000010101
101011101111101011111110101011101110111111101110101
101000101000000010001000000000100010000010000010001
111110111011101010111110101110101111111110101111111
100000000010001000100000101000000000001010101010001
111011111011111010111111101110101111101011111011101
100010001000100010100010001000101010100000100000101
101110101110101011101011111110101010111011101110101
100000101000101000001000000000101000100000100010001
101110111110111111101110101110111010101111111010101
101000100010101010000010101000001010100010000010101
101110111010101011101111111010111110101011101011111
101000100000000010000000100010000010001000001000001
111111111111111111111111111111111111111111111111111
