111111111111111111111111111111111111111111111111111
100010000000000010001010001000100000100010000010001
101110111110111110101010101010101110101011101010101
100000100000100010100010101010000010001000101000101
101111101111101010111110101111111111111110111110101
100000100000101000100000101000000000001000000010101
111111111110101110101111101011111111101011111010111
100000000000100010100000101000000000100010001000001
101111111011111011111010101111101110111110101111101
100000001000001000001010101000101000001000100000101
111111101111101011101110101010101011111011111110101
101000101000100010001000101010101010100000000010101
101010101010111111111011101010111010101111111010101
100010001010100010001000101010001010100000101010101
101111111010101010101110101011101010111110101010111
101000000010001000100000100010000010100010001010001
101011111111111011101111111110111110101111111011101
101000100000100010001000000010100010100000001000101
101110101111101110111011101011101010101011101110101
100000001000100010001010001000001010001000100010101
111111111010101011111010101111111010111110111010101
100010000010001010000010100000001010100000101000101
101110111111111010111111111111101011101111101011111
101000100000100010001000001000001000100000001010001
101011101110101111101011101111111010111110111010101
101010001000100000001010001000100010100010001010101
101011111010111111111010101010101010101111101010101
101000000010001000100010101010101010001000101010101
101111111111101010101111101010101111111010101010101
100000000000101010001000100010001000100010101010101
101111111110111011101110111110111010101110101010101
100000001000100010001000100010001010100010101010101
111111101011101110111011101011101011111010101110101
100010001010001010100010001010001000001010100010101
101011101010101010101011111010101111101010111010111
101000101000101000101010001010100000101010001000001
101110101111101111101010101011111110101011101111101
100010101000100000101010100010000000101000100010001
111010101010111110101010111110111011101110111010111
100010001010100000001010000010100010000010100010001
101111111010111111111011111010101110111010101111101
100000100010000010001000001010101000100010101000101
111110101111111010101111101010101011101110101010101
100010000010001010100000001010100010001000101010101
101111111110101011111111111010111111111111101010101
100000101000100010001000100010100000000000001010101
101010101011101110101110101110111110111011111110101
101010001000101000100000101000100010001000100000001
101011111110101010111110101011101011101011101111101
101000000000100010000010001000001000001000001000001
111111111111111111111111111111111111111111111111111
