111111111111111111111111111111111111111111111111111
100000000010001000100000100000000000100010000010001
111010111110101010111110101111111011101010111010111
100010100010101010000000101000101000001000100010001
101110101010111011111111111010101111111111111010101
101000101000001000100000000010000000000010001000101
101011101011101110101111111011111111101010101111101
101000101010100010000010001010000000101000100010001
101110101010111011111010101010111110101111111110101
100010101000100010000010100010100000101000000000101
111011101111101110111110111110101111101011111111101
101000001000001000100010000000100010001010000000101
101110101111101110101011111111111110111010111111101
100010101000100000101000000000000000100010000000101
101010101010111111101111111111111111111110111110101
101000100010101000100010001000000000100010000010101
111111111110101011111010101011111110101011111010101
100000100000100010000010101000001000001000001010001
101110111110101110101110101111101111111011101011111
100010000000101000101000101000000010001000101000001
111011111111101010101011101011111010101110101111101
101000001000100010101010100010001000101010101000001
101110101010111110101010111111101111101010111011111
100010101010100000100010100000001010001010000000101
111010101010111111111110101011111010111011101110101
101000100010100000001000101000100010001000100010001
101111111110101010101011101010101111101011111011101
100000000010001010101010001010101000101000000010001
101111111111111110101010111010101110101111111110111
100010000000000010101000100010000000100000100010001
111011111011111010101011101111111111111110101011101
101010000000101010101000100010100010001010001010101
101010111110101010111110111010101010101011111010101
100010100010100010000000100010001000100000000010001
111010101010111111101111101110111111111011111111101
100000101000100010001000100010001000100010001000001
101111101011111010111110111011101010111110101111111
100010001000000010100010000010100010000010100000101
111110111011111110111011111010111011111010111010101
100000100010000000001000001000101010000010001010001
111011101110111110101111101011101011111111101111101
100010001000101000100010001000101000001000100000101
101111111011101011111010111110101111101010111110101
100000001000101000100010100000001000100010100010101
101111101110101011101010111011111010111011101010101
101000001010101010001000100010001010101010001010101
101011111010101010111111101110101010101010111010101
101000000010100010000000100010100010101000101000101
101011111110111110111110111011111110101011101011101
101000000000100000100000100000000000001000100010001
111111111111111111111111111111111111111111111111111
