111111111111111111111111111111111111111111111111111
100000000000000000000000000000000000000000000000001
101010101111111111101111111011101011111010111011111
101010100000000010001000000000101000001010100000001
101111101110101011101010111111111110101110101011101
100000101000101010001010100000000000100010101000101
101011111111101111111010101110111010111110111111111
101010000000000010000010101000001010100000000000001
101010111110101110101110111110101111101011101010101
101010100000100010100010100000100000101000101010101
101111111011101011101111101110101110101010111010111
100000100000101000100000100010100010101010001010001
101011111110101111101011111010111011101011101110111
101000100000101000001000001010100000101010001000001
111110101010101111111111111010111110101010111010101
100000101010100000001000000010001000101010100010101
101110111010101011101011111111111111101010101111101
101000001010101010001000000000100000001010100010001
101010111111101010111010111010111110101111111010101
101010000000101010100010001010100000100010000010101
101011101111101111101011101111111010101111111011111
101010001000000000101010000010000010100000100000001
101111101110111111101111111111111011101111111010101
101000000010100000000000000000001010000000001010101
101010101110101010111110101111101011111010101111111
101010101000101010001000100000101010000010100000001
101011111011111111111011111111111011111110101010101
101000001010000000000000000000001000001000101010101
101111101111111111101111101011101011101010101011101
101000000000000000101000001000101000101010101000101
111010111010101110101110111010101110101111101010111
100010100010101000101000001010100010101000001010001
101111111111111110111111111110111111101110101010101
101000000000000000000000000010000010000010101010101
101010101011111111111010111011111111101010101010111
101010101000000000001010001000100000001010101010001
101110111011111010111010111010101111101110101111101
101000001000001010001010100010100000100010101000001
111110111011111110101110111110111111101110111110111
100000100000000010100010100000100000001000000010001
111111111011101010101011111010111011111011111110101
100000000000101010101000100010001000001000001000101
101011111011101111111010111010111110111011101110101
101000100000100000001010100010100000100000101000101
111110111111111010111011111111101111111011101110101
100000000000001010100000000010000010000010000010101
111010111011111110111110111011101011101110101110111
100010001000100000000010001010001000100010100010001
101110111010111011101110111011101011111011101110101
101000001010100010001000100000101000001010001000101
111111111111111111111111111111111111111111111111111
