111111111111111111111111111111111111111111111111111
100010000010000000001000000000001000000000000010001
101010111010111110101010111110111011111111101110101
101010100010100000101010000010100010100000100000101
101110101111101111101011111011101110101010111111101
101000100000100000101010001000101010001010000010001
101110111110111110101010101110101010111011111110101
100000100010000010101000100010001000101000100000101
111111101011111010101111111011111110101110101111101
100000101010001010100000001010000010101000101000101
101110101010111010111111101010111010101011101110101
100010101000100010100000001000100010001000100010001
101010101110101110111110111111101111101110111011101
101010001000101000100010100000101000001000001000101
111011111111101110101011101011101011111011101110101
100010000000001000101010001010001000101010001000101
101110111111111011101010111010111110101011111011101
101000100000000000001000101000100010001000001000101
101011101111111111111111101111101111101111101110111
100010001000000010001000001000100010001000100010001
101110111111101010101011101010111010111010111011101
100010100000001000100010000010100010100010101000101
111010101111111111111111111110101110101010101011101
101010001000000000000000100010100010101010001000101
101011111011111111111110111010111010111011101110101
101000000010001000000010100010001000000010000010101
101111111110101010101110101111101111111111111110101
100000000000101010101000100000100000000010000000101
101111111111101110101011101011111111111010111111101
100010000010000000101000101000100000001010100010001
101010111011111111101110111110101110101010101010101
101000001000100000101010000010001000101000101010101
111111111110111010101011111011111011101110101010101
100000000000100010100000001010001000101000101000101
101111111111101111111111101010101010101011101111101
100000100000100000001000001000101010101010101010001
111110101011101110101011111111101010101010101010111
100000101000000010101010000000101010101010101010001
101111101111111110111010101111101010111010101011101
101000100010000010000000101000001010000000101000101
101010111110111011111111101011111011111111101010101
100010001000101000001000001000101010100000001010101
101111101011101111101111101110101010101111111010101
100000100010000000100000101000101000101000000010101
111110111110101011111110101011101110101111111011101
100010100000101010000010101000100000100000100010001
101010111111101110111010111110111111101110101110111
101010000000100000100010000010100000101000101000101
101111111110111111101011101110101110111011101011101
100000000000000000001000100000001000000010000000001
111111111111111111111111111111111111111111111111111
