111111111111111111111111111111111111111111111111111
100000101000000000001000000010000000001000000000101
101110101010111111111011101010111111111011101110101
101000101010000000000010001010100000000010001010101
101011101011111111101110111010101111111110111010101
101000001000100000100010100010001000100010001000101
101111111011101110111110101110111010101011101110101
100000000010001010001000100010000010001000100010001
111111111110111011101011111011111111111011111011101
100000001000100000001010001000000000100010000010001
101111111011101111111010101111111110111010111111111
100000001000100000100010100000100010001010000000001
111111101110111110101110111110101011101011111110101
100000101000100010100010000010001000101010000010101
101010101011101110111011111011111011101110111011101
101010100010001000100010001000001000100000101000101
101010111110101011101110101111101110111111101110101
101010100000101000101000101000000010001000000010101
101010101111101110101010101111111110111011101110101
101010100000100010001010100010000000100010100010101
101011111110101111111110111010111110101110111010101
101000001000100000000000101010000010100010001010101
101111101011111011111111101010111011111010101010101
100010001010001000000000100010100010001010101000101
111010101010101111111110111011101110101010111111101
101010101000100010000010001000101000100010000000101
101010111111111010111111101110101011111110111010101
100010000000100010000000100010001010001000001010001
101111101110101111101010111011101010101111111011101
100010101000101000101010101000101000100000100010001
111010101110101010111010101110101111111110101110111
100000100010100010100010100010101000001000101000101
101111111011111110101110111010111011101011101011101
101000001000000010001010001010000010001000101000001
111011101110111011111011101011111110111110101111101
100010000010001010000000101000000010000010001000001
101111111011101110101110101011111011111011111011111
101000001000101000100010101010000010001000001010001
101011101110101011111010101010101110101111101011101
100010001000101010100010101010101000100000001010001
101110111011101010101110101110111011111110111010101
101010100000101000101010100010001000000010100010101
101010111110101110101010111010101111111011101110101
101010001010100010101000001010100000001000001000101
101011101010101110101111111011111110101111111010101
101000101000001000101000001000001000100000100010101
101110101111111011101011101111101011111110111110101
100000100010001010101010001000100010001000100010101
111110111010101010101010111010111110111011101010101
100000001000100000100010000010000000000000001000101
111111111111111111111111111111111111111111111111111
