111111111111111111111111111111111111111111111111111
100000001000100000000000000010001000001000000010001
101110111010111110111111111110101111101010111010101
101000000010000000100010000000101000100010001010101
101111111111111111101011111111101010111011101110101
100010100000000000001000001000101010000010001000101
111010101111111111111011111010101011111111111011101
100010001000000000000010000010001010000010000010101
101110111011111111111010111111111010111010111110101
100010100000100010001000100010000010001000101000001
111010111110101010101111101010111011111110101011111
101000100010001010101000101000101000001000001000101
101111101011111010101010101111101110101011111110101
100000101010000010101010001000100000101010100010001
111110101110111110101111111010101111101010101111101
100000100000101000100000001010001000101000100000001
101110111110101011111111101111111010101011111110111
100010001000101000001000001000000010101000100010001
101111101011101110101011111011111110101010101011101
100010001010001000101010001000000010101010101010101
111010111011101110101011101111111110101011101010101
101010000010000010101010001000000010001000101010001
101011111110111010101010101011111010111110111010111
100010000010001010101010100010001000100010001000001
101110111011101011101010111110101110101011101111101
100010001000001000001000100000100010001000000000101
111011111111111011111111101111111011111111111110101
100000001000000000101000000000100010000010000000101
101111101011111110101011111110101110111010111111101
100000100010001000001010000010101000101000100000101
111110111110111011101010111010101010101111101110101
100010000010100010001010001000101010100010001000101
101111111010101110111111101111101010111011101111111
100000000010101010001000101000001010000010000010001
111111111110101011101010101111111011111110111010101
100000000010101000100010100000000010001000101000101
101111101110101110111110101111111110101011101111101
100000101000100010001010101000100000101000100000101
111011101011101010101010101110101111101011101011101
100010001000101010100010100000101000001010001000101
101110111110111010101110111110111011111010101110101
101000001000100010100000000010000010001010100010001
111011101011101111111110111111111110101110111111111
100010100000100000000010000000000000100010000000001
101110111110111110111011111111111111111011111111101
100010001000000010101000100000000010001010000000101
111010101011111010101010111111111010111010111110101
100010101010000010100010000000001000001000100010001
101010101011111111101111111110101111101110111010111
101000101000000000001000000000100000100000000010001
111111111111111111111111111111111111111111111111111
