111111111111111111111111111111111111111111111111111
100010000000100010000000100010001010100010100000101
101111101110111010101110101010111010101010111010101
101000100010100010101000001000100000101010000010101
101011101010101010111110111110111110111011101110101
100000001010001000001000100000001000000000100010001
101010111010111011111111111111101110111111101010111
101010001010001010001000001000001010000000101010001
101111111111101011101011101111101011111011101111111
101000101010001000001000101000100010100010000000001
111110101010111011101111101011111010111010111110111
100000101000100010100010100000000000001000100000001
101110101011111110111110101110111111101110101110111
101000100010100000001000100010100010100000101000001
101110101110101110111011101110111010111110111111101
100010000000001000001000101000101000100000100000001
101011111010111111101011101110101011111110111010101
101010100010001000000010100010101010001000100010101
111110111111111011111010111011101011101010111111101
100000101000000010001000101010000010001010100010101
101110101111111011101011101011111011101110101110101
100010001000000000001010000010001010000000000000101
111110101010101110101110111010111011101010101010101
100000100010100010100010101010001010001010101010101
111111111110111111101011101110101010101011101011111
100000001010100010001000000000101000101010101010101
111010111010101110111111101010111111111010101110101
100010001000000010101000101010101010101000100000101
111111101111111011101110111011101010101111101011101
100000001000100000001010001000100010101000101000001
101110101010111110111010111110101110101010101011111
100010101010100000100010000010100000000010001000001
101011111011111011101011101111111111111011101010111
101010000010100000001010101010001000001010001010001
101111101110111011111010101011101110101110111010111
101010000000100000101000101000100000100010100010101
101011111110111011101110101011101011111011111110101
100000100010001000100010101000001000001000001000001
111010101110111110101010101011101011111111101011101
100010100010001010101000001010001010000010001010101
101110101011101011111111101110111111101110111110111
101010101010100000001010000010101010001000000000001
101011111010111010111010111010101011101110111110111
100010000000001010001000100010000000001010000010101
101110101011101110101010101011101110101011111010101
100010101000101000101010101000100010100000001010001
101110111010111011101111111110101110101110111111101
100000001010000000100000000000001010100010000010001
111011111010101111101010101010101010111011111011101
100000100010100000101010101010101000001000100000101
111111111111111111111111111111111111111111111111111
