111111111111111111111111111111111111111111111111111
101010001000100010100000101010001000101000001000101
101010111011101110101111101010111010101011111011101
100010000000101010000000100000101010000010100000101
101110101011101010111111101110101111101010101111101
101000101010000000100010001010101010001010000010001
101110111011101110101111101011101011101110111010101
101010001010101010001000000000000000100000101000101
101010111110101011111110111110101111101111101111111
100010001000000000000010100010101000001000000000001
111010111011101110111111111010111111101110111010101
100000100000100010001000001010100000000000001010101
111110101111101011111110101010101110101110111011111
101000001010101000101000100000001010100010001010001
101010111010111011101111101110101011111111111110111
101010000000001000100000000010100000001000101000001
101110111111111111111110101010111010111011101110101
100010001010001000001000101010001010000010000000101
111010111011101110111110111110111110111011101110101
100000101010000010001000101010100000001000000010101
111010101011111011101010101011111011101110101010111
101010000000100000100010000000100000100010101010001
101111101110111110101111111111111111101010101111101
100000001010000000000000000010100010101010100000101
101110101010101010111110111110111010111111101010111
101000101000101010000010100000000000000000101010001
111110101110101011111010101110101110101110101111111
100000100010101010100010000010100010101000100000001
101110111011101110111110101111111111111110101110111
100010100000100000001000101010000010101010101000001
101111101110101111111110111010111110101011111110101
100000100010100000001000100000101000000000001000101
111011101110111110111010111011101011111111111110111
100010001000000010100010000000000000000010001010101
101110101010111010111111101110111111111110111011101
101000101010101010001000001000000000000010000010001
111011101110101011111110101111101111101110111111101
100010000010001010001000100000100000100000000000101
111111101010111110111110101111101110101010111011101
100000001010000000000010100000100010101010101000001
111111111011111010111011101110111111111011101011111
101000000000001010001000101000100010001010001000101
101010101010101110111110111010111010111010101111101
100010101010101000100010101010000000100000101000001
101110111011111110101111101110101110111010111011101
101000100010100010000000100000101000001010000010001
111110111010101010111110111011111110111110101010101
100000100000001010001000100000000010001000101010101
111110111111101111101110111010111110101110101011101
100000001000000010001000100010001000100010101010001
111111111111111111111111111111111111111111111111111
