111111111111111111111111111111111111111111111111111
100000000000000000000000000000000000000000000000001
101011101110111010101010101011111010101110111011101
101010001000001010101010101000001010101000001000101
101111101010101010111110111011101111111111111110101
101000001010101010100000100010001000000000000000101
111011111111101110101110111111101110111011101011101
100010000000000010100010000010001000001000101010001
101111111011111111101011111010101010111111101010101
100000001000001000001000001010101010100000001010101
101010111011111111101110111010101111101011101011101
101010001000000010001000100010100010001010001010001
101010101111111111101010111010101011111111101110101
101010100010000000001010001010101010000000000010101
101111101110101011101110111110101110111111101011101
100010001000101010000010001000101000000010001000101
101010101010111010111111101011111010111111111110111
101010101010100010001000001010000010000000100000001
101110111110111010101011111010101110111010101111101
101000000010001010101000100010101000100010101000001
101010111111101010101011111110111010101111101110101
101010100000001010101000100000001010100000100010101
101110101111101011101110111011111011111010101010101
101000101000001010000010001000100000100010101010101
111110101110101111101111101010111111111111111111101
100000101000101000001000001010000000000010000000001
111111111110101110111011101110111011111011111010101
100000000000101000001000100010001000100000100010101
111010111011111010101010111110101111111110111011111
100010001000100010101010000010100000001000100000001
111011111010111011111110101110101110101011111011101
100000001010100000000010101000100010101010000000101
101011101111111110111011111111111010101111111110101
101010000000100000001000001000000010100000001000101
101011111111111011111011111110111110101011111010101
101000000000001010000010000000001000101000100010101
101011101011101110101111101111101011111111101110101
101000101000101000100010000010001000000000101000101
101111101011111111111011111111111111111011111110101
101000001000000000100000000000001000000000000010101
111010101011111011111111101110111111101010101110111
100010101010000010000000001000000010001010100010001
101010101110111011111011111010111011111111101010101
101010101000001010000000001010100010000000001010101
101110101010101111101110101010111110101011111011101
101000101010100000101000101010100000101000001010001
111011111110101110111011101010111011111111111010101
100000000010100010100010001010001000000000001010101
101111111010101110111110111010111011101110101010101
100000001010101000000010100010100000100010101010101
111111111111111111111111111111111111111111111111111
