111111111111111111111111111111111111111111111111111
100000100000101000000000100000100010100000001010001
101110101011101011111011101111111010111010111010111
101010001000000000100000000010000000101010101000101
101011111011111011111111111011111010101011101011101
101010000010000000000010000010100010001000000000101
111010111111101110111011111110101111101011111110101
100000100000000010100010100010100000100000100000001
111111111011101111111010101010111110111011111010101
100010000010000000100010001000100000001010001010101
101110111011101110101111101111101011101111101111111
100000100010000010100000100010001010000010000000001
101011101110111111111010101110111111111111101110111
101000101010100010001010101000000000000000100010001
101111101011111010101111101011101011111110101011111
101000001000000000101000000000101000100000101010001
101111101011101111101110111111111111111110111010101
101000001010001000000000001000100000000010000010101
111010111110111111111010111011101111111111111011101
101010000010001010000010001010000000101000101010101
101111101111111010111110111011101110101010101110101
101010001000000000101000100000001010001010000010001
101010111011111010101110111011101011101111101110111
100000000000100010000010000000101000001010001000001
111110111010101011101111101011111110101011101110101
101000100010101010001000101000100000100000100010101
101011111011111011101110111111101111101110101110101
101010001010101010100010001000000000100010000000101
101110101010101110101110111110111011111111111010101
100010101000100000101000001000100000100010000010101
101010101010101011101011101110111010111010101011111
101000101010101010000000101010100010001010101000001
111111101011111011101011101011111111111010111110111
101000100010000000101010100000101010100000100010101
101110101110111110111010111111101010101111111010101
100010000000100010100010000000000000101000101000001
111010111011101111111011101111101011101011101111111
101000001000101000000000001000101010000010001000001
101111101111101110111110101011111011111011101011101
101000001010100000001010100000100010001000001010001
101011101010101010111010111111111110111010101011101
100010101010001010001010000000100000000010100000101
101110101011101110101010111111101110111111101011111
101010100010000010101010100000101010001010101000001
101010101110111011111011101110111011101010101110111
100010000010101000001010001000000000000010001000101
111111111011101111101011111111101111101011101010101
101000000000100000100000000010000010001010001010001
101111111011101110111011101010101011101011101010101
100000000000101000000010001010101000101000101010101
111111111111111111111111111111111111111111111111111
