111111111111111111111111111111111111111111111111111
100010000000101000001010101000001000000010001010001
101110111111101010101010101110101011111011101010111
101000100000001010100000101000101010001000001010001
101010111010101011111110101110101010101010111011101
100010000010100010100000101000100010100010001010001
101111111010101010101110101111101011101110101011101
100010000010101000101000000000001010000010100010001
111111111111111111111111101111111111111111111110111
101000101000000000100010100000100010100000100010001
101011101011111011101010101110101010101010101010101
101000101000100000001010001010101000001010001010101
101011101110101010101110101010111111111111101110111
101000000000101010100000100010001000001000100010101
101111111111111111111011111111101010101010101010101
101000000010001000101000100010100010100010001010001
101010101010111011101110111010111111111111111010111
101010101010000010100010100010100010000000100010001
101011111010101010101010101010111011101010101010101
101010001000101000001000101000100010001010001010101
101010101010111111111110111110101111101110111011101
101000101010101010001000100000100010001000001000001
101110111110101010101110101110111011101010101011101
101000000010001000101000000010100000101010101010001
101111111011111011101010101111101110101110111011101
101000000000001000100010100010100010001000001010001
101110111111111110111111101010101011101111111010111
101000000000001000000000101000101010000000001010101
101110111111111111111111111111111111111111111010101
101000001000001000100000100000101000001000001010001
101010101010111110111011111011101011111110101010111
101010100010001000100010100010101010000000101010001
101111111011111011101010101010101011101110111011101
101000000010001000001000101000100000001000001010001
101111111010101110111111101111101111101110101010111
100010001000101010000010100000101000001000101010001
101010111011101011101110111011101011111011111011101
101000001010001010001010000000101000001000000010101
101011111010111011101010111110111111111110111110101
101010001010001010000000101000100010000000000010001
101010101010111011101111101010101010111111111111101
101000100010000000000000100010101010100000001010001
101111111111111111111011111111101110101111111011101
101000000000100000100000100000100000101000001010001
101110101111111110111011101010101110101010101010111
101000101010000000100000001010100010001010101010101
101011101010101010101010111110101110101110111010101
101000100000101010101010100000100010100000000010001
101110111110101111101111111110111010101010101010111
101000100000100000000000100000100010101010101010001
111111111111111111111111111111111111111111111111111
