1111111111111
1000100000101
1011101110101
1000101010001
1110101011101
1000101010001
1011101010111
1000100010101
1010111110101
1010000010001
1011111011101
1000001000001
1111111111111
