1111111111111
1000100000101
1010101110101
1010100010101
1011111011101
1000001010001
1110111010101
1000100010101
1011101110101
1000001000101
1011111011101
1000000010001
1111111111111
