1111111111111
1000000000101
1011111010101
1010000010001
1111111011101
1000000000101
1111111110101
1000000000101
1010111011101
1010100000101
1111111010111
1000000010001
1111111111111
