1111111111111
1000000000001
1110111111111
1000000000001
1011111010111
1000100010001
1011111010101
1010000010101
1011111111101
1000000010001
1111101110101
1000001000101
1111111111111
