1111111111111
1000001010001
1011101010101
1000100000101
1110111111101
1000101000001
1010101011111
1010101010001
1010101011101
1010101010001
1110101010101
1000100000101
1111111111111
