1111111111111
1000001000101
1110111110101
1000000000001
1010101110111
1010101000001
1110111011101
1000001010001
1110111110111
1010101000001
1010101010101
1000001010101
1111111111111
