1111111111111
1010000010001
1010111011101
1000001000001
1111101111111
1000100000001
1011101111101
1010000000101
1011111111101
1000001000101
1111101010101
1000000010001
1111111111111
