1111111111111
1010100010001
1010101011101
1010101010001
1010101110111
1000001000101
1111101110101
1010000000001
1010101011101
1010101000101
1011111010101
1000000010101
1111111111111
