1111111111111
1010000000001
1010111011111
1000101010001
1010101111101
1010000000001
1110101111111
1000100000001
1111111011101
1000100000101
1110101011101
1000001010001
1111111111111
