1111111111111
1000000000001
1111111011111
1000000000001
1011101110101
1000101000101
1010111011101
1010100000101
1110111110101
1000000010101
1010101010111
1010101010001
1111111111111
