1111111111111
1000101000001
1110101010101
1000100010101
1010111011101
1010100010001
1011111111101
1000100000101
1011111110101
1000101010001
1011101010101
1000000000101
1111111111111
