1111111111111
1000000000001
1011111111101
1000100000001
1110101111111
1010101000001
1010101011111
1010101000001
1010101111101
1010100000001
1010111111111
1000000000001
1111111111111
