1111111111111
1000000000001
1010111111101
1010000000101
1111111110101
1000000010101
1011111010111
1010100010001
1010101111101
1010100000001
1010111111101
1010000000001
1111111111111
