1111111111111
1000000000001
1011101110101
1000101000101
1010111111101
1010001000001
1111111011101
1000000010001
1010101010111
1010101010001
1011101111101
1010001000001
1111111111111
