1111111111111
1000000000001
1010111010111
1010100010001
1010101111101
1010101000001
1010111110101
1010001000101
1011101010101
1010001010101
1110101011101
1000101010001
1111111111111
