1111111111111
1010101000101
1010101011101
1000001010101
1011111010101
1000000010001
1011101110101
1010000010101
1111101110111
1010000000001
1011101111111
1000000000001
1111111111111
