1111111111111
1000000000101
1011101111101
1000101000001
1111101011111
1000001000101
1011101010101
1000100010001
1111111110101
1000000000101
1011111011111
1000100000001
1111111111111
