1111111111111
1000000000001
1011101110101
1010000010101
1010111010101
1010001010101
1111111110111
1000000000001
1110111011111
1000100000001
1110101111101
1000100010001
1111111111111
