1111111111111
1010100010101
1010101010101
1000101010001
1011111011101
1000000000101
1111101111101
1000100000001
1010111010101
1010101010101
1110101011111
1000000000001
1111111111111
