1111111111111
1000000000001
1011101111101
1010001000001
1010111011111
1010101000001
1110101111111
1000100000001
1010111111101
1010001000001
1011101011101
1000100010001
1111111111111
