1111111111111
1010001000101
1010111110101
1000100000001
1011101110101
1000101000101
1110101010101
1000001010101
1111111011111
1010101000001
1010101011101
1000000010001
1111111111111
