1111111111111
1000001000001
1011111010111
1000001010001
1011101011111
1000100000001
1011111111101
1000001000001
1111101111101
1010001010001
1010101010111
1000101000001
1111111111111
