1111111111111
1000001010001
1011111011101
1000101010001
1011101010111
1000000000001
1011101011101
1000101000101
1011111011101
1010101000101
1010101111101
1000000000101
1111111111111
