1111111111111
1000000000101
1011111110101
1010001000101
1011101110101
1000100010101
1011111010101
1000001010101
1011101010101
1010001010001
1010111011101
1010000010001
1111111111111
