1111111111111
1000001000001
1011111011101
1000001010101
1111101010101
1000001010001
1111101011111
1000100010001
1110101110101
1000100000101
1011111111101
1000000000001
1111111111111
