1111111111111
1000000000001
1111101111111
1000001000001
1010101011111
1010100010001
1011111010101
1010101000101
1010101111101
1000001000001
1110111110111
1000001000001
1111111111111
