1111111111111
1000001000101
1111101010101
1000100010001
1010111010111
1010000010101
1110111011101
1000100010001
1011101110111
1010001000001
1011111111101
1000000000001
1111111111111
