1111111111111
1010000000001
1010101010101
1000101010101
1111101111111
1000001000101
1111101011101
1000001000001
1011101011111
1010001010101
1011101010101
1010000000001
1111111111111
