1111111111111
1000000000001
1111101111101
1000000010001
1010111110111
1010100000001
1010111110101
1010000010101
1010111010111
1010001010001
1011101111101
1000100000101
1111111111111
