1111111111111
1000000000001
1110111010101
1000001010101
1010101110111
1010100010001
1010111110111
1010000010001
1011101111101
1000100000101
1111101011101
1000001010001
1111111111111
