1111111111111
1000000000001
1010101011111
1010101000001
1010101111111
1010100000001
1010111011101
1010100010001
1011101010101
1000101010101
1111101010111
1000001010001
1111111111111
