1111111111111
1000100000001
1110101111101
1000101000101
1010101110101
1010101000101
1011101011101
1010001010001
1010111010111
1010000010101
1011111110101
1000000000001
1111111111111
