1111111111111
1010001010001
1011101011101
1000001000001
1011101110111
1000100000001
1011111110111
1000000010001
1110111010111
1000100010101
1111101011101
1000001000001
1111111111111
