1111111111111
1000000000001
1111101111101
1000100000101
1010111110101
1010001000101
1010111011101
1010100010001
1011101110111
1000000010001
1111111111101
1000000000001
1111111111111
