1111111111111
1010001010001
1010111010111
1010000000001
1011111110111
1000100000001
1011111110111
1010000000001
1011111110111
1000100000001
1011111110111
1000000000001
1111111111111
