1111111111111
1000000000001
1111111111101
1000000000101
1011111110101
1000100010001
1110101011101
1000101000101
1011101011101
1000101000101
1111101110101
1000000010001
1111111111111
