1111111111111
1000000010001
1011111010101
1010001000101
1011101111101
1000001000101
1111101010101
1000001010001
1011111011101
1010001010101
1010111010101
1000100010001
1111111111111
