1111111111111
1010000000101
1010111011101
1010001000001
1010101110101
1010101000101
1011101111111
1010000000101
1010111010101
1010101010001
1010101111101
1000001000001
1111111111111
