1111111111111
1000001000101
1011101010101
1000101010101
1010111010101
1010001010101
1011101011101
1010001010001
1110101010101
1000101010101
1011111010101
1000000000101
1111111111111
