1111111111111
1000101000001
1010101011101
1010101000101
1110101110111
1000100010001
1011111010101
1000001010101
1010101011101
1010101000001
1010111111101
1010000000001
1111111111111
