1111111111111
1010000000001
1010111111101
1000100000101
1011101010111
1000101010101
1110111010101
1010000010101
1011111110101
1000100010001
1010101011101
1010001000001
1111111111111
