1111111111111
1000000010101
1010111010101
1010001000001
1011101111101
1000100010101
1011101010111
1000101010001
1011111010101
1010001000101
1010111110111
1000000010001
1111111111111
