1111111111111
1000000000001
1111111110111
1010001000001
1010111010111
1010000010001
1011101111111
1010001000101
1011101010101
1010001010001
1011101111101
1000000000001
1111111111111
