1111111111111
1000101000101
1110101110101
1000100000001
1110111111101
1000000010001
1110111011101
1000100000001
1011111010111
1000100010001
1110101111101
1000100010001
1111111111111
