1111111111111
1000001000001
1111101011101
1000000000101
1011111111101
1000100010001
1010101110111
1010100010001
1110111011101
1010100010001
1010101110111
1000100000001
1111111111111
