1111111111111
1000000000001
1111111011101
1000101010001
1010101011111
1010101000001
1010101111101
1010000000001
1011111011111
1000001000001
1111111111101
1000000000001
1111111111111
