1111111111111
1000000000101
1111101111101
1000001000101
1011101110101
1010000000001
1011101111101
1010100010101
1010101110101
1010000000101
1110111111101
1000000000101
1111111111111
