1111111111111
1000000000001
1011101111101
1000100000101
1011101111101
1000101000001
1011101111111
1010000000001
1110101111101
1000101000001
1010111010101
1010100010101
1111111111111
