1111111111111111111111111111111111111111111111111
1000000010000000001000000000001000000000001000001
1110111011111010111011111110111011111011101011101
1000100010001010001000100010000000100010001000101
1011101110101011101110101111111111101110111110101
1010101000101000100000100010000000101000000000101
1010101011101110111111111010111110101111111111111
1010000010100010001000000010100000100000100010001
1011111110111011101110111010111011111110101010101
1000100000001010001000100010001010000010101000101
1110101111101010111010111110101010111010101111101
1000100000101010000010100010101000100010001000101
1011111110111010111110101010101111101111111010101
1000100010001010100010101010101000101000001010101
1110101011101011101011101010101110101011101010101
1000101000100000001000001010100010001010100010101
1011101110111111111111111011111010111010111110101
1000001010000000100000101000001010000010000010001
1011111011111110101110101111101010111111101111101
1010100000000010001000100000000010100000100000001
1010101011111111111011111011111111101111111111101
1010001000000010001000001010000000101000001000101
1011111111101010101111101110111110101011101010111
1000000000101000100000100000100010100010101010001
1111111110111011111011111111101010111110101011101
1010000010001000001010000000001010000000100010001
1010101111101111101010111110111111111110111110111
1000100010001000101000101000100000001000100010101
1011111010111011101111101011101111101010111010101
1010001000100000000000001000001000101010000010001
1010101111111111111111111111101010101011111011101
1010100000000010000000000000101010101000001000101
1010111111111010111111111110111010101111101111101
1010100000000000100010001000100010101000001000101
1010111111111111101010101110101110101011111010101
1010100000100000001000100010001000101010000010001
1010101110101111111111111011111011101010111111111
1010000010001000100000100010001000001010100000001
1011111011111010101110101110101111101010101110101
1000001000000010101010100010100000001010101000101
1111101011111110101010111010111111111010111011101
1000001010001000101000000010100000001010100010101
1011111010101110101111111110111110111010101110101
1000100010100010100010000010000010100010001010001
1110101110111011111010111111111010101111111010111
1010100010001010001010100010000010101000000000101
1010111111101010101010101010111110101011111111101
1000000000001000100010001000000000100000000000001
1111111111111111111111111111111111111111111111111
