1111111111111111111111111111111111111111111111111
1000000000001000000010000000000010100000100000001
1010111111101011101010111110111010101011101111101
1010100000001010001010001000100000101010001010001
1110101111111110111011101011111111101010111010101
1000100000000010101000101000000010001000000010101
1011111111111010101110111111111010111111111110101
1010000000001000100010000000100010100000100000101
1010111111101111101111111110101110101110101111101
1010100000100010000000001000100000100010100010001
1011101110101010111011101011101111111010111010111
1000101000101000101000101010100010000010100010001
1010101011101111101110111010111011111010101111111
1010001000101000000010100010001000001010101000001
1011111110101011111010101110111111101110101011101
1010100000101010000010001000100000001000100000101
1010101111101010111111111010101111111010111111101
1000101000001010100000100010100000000010001000101
1110101011111011101110101110111111111110111010101
1000101010100000001010001000000010100000100010001
1111101010101111111011111011111010101111101111101
1000001010001000000000001010001000100010001000001
1011111011101110111110111010101111111010111111101
1010001000100010100010001000101000000010000000101
1010101110111011101011101111101011111111101110111
1010100010100000001000100000100000100000100010001
1010111010111111111110101011111110101110111011101
1010100010000010000010001010001000101000100010001
1010111111111010111011101110101111101011111110101
1010000000001010001000101000101000101000000000101
1011101111101010101110111011101010101111111111101
1000101010001010101010001000100010100000100000101
1110101010111011101011101010111110101110101110101
1010101010001010001010001010001010101000101000101
1011101011101010111010111111101010111011101110101
1000100000100010100010000010001010100010100010101
1011111110111110101011111010111010101110101010101
1010001000100000101000001000100010001000001010101
1010101011101011101111101111101111111011111010101
1000101000101010001000001000100000100010000010101
1011101110111010101011111110101110101110111110101
1010100000100010101000000000101010100010100000101
1010111111101111101111101111101010111010111111101
1000100000100010001000001000101010000010100000001
1110111010101010101111111010101011111110101111111
1010000010101010101000001010101000100010100000001
1011111110111010111011101010101010111010111111101
1000000000000010000000100010000010000010000000001
1111111111111111111111111111111111111111111111111
