1111111111111111111111111111111111111111111111111
1010000000100000001010001000001010100010001000101
1011101011101111111010101111101010101110111010101
1000101010000010000000100010101010000010001010101
1110101111111011101010111010101011111010111011101
1000100010100000101010101000100010001000001000001
1110101110101011111110101111111010101011101011111
1000001000001010001000001000001000100010101000001
1111101111101010111111101111101011111010111011111
1000100000101010000010101010100010101010101010001
1110101110101110111110101010101110101010101011101
1010001000100000100000000000000010100000001010001
1010111111101111101111111011111110101011111010111
1000000000100000000010101000101010001000100000001
1011111111101010111110101011101010111111111110111
1000100010001010101000001010001000001010001000101
1010101111101111101011111010101110101010101011101
1010101000001010000010001000100010100000101000001
1011101111111011111011101011111110111010111011111
1000000000101010000010000000100010101010000000001
1110111110101011111010101111101010101010111110111
1000001000100000100010100010001000001010100000001
1111111010111110101111111110111110101111101111111
1000100010000010001000001010001000101010101000101
1110101011111111101111101011111011111010101011101
1010001000100010001010001010101010100010100010001
1011111110111010111011101010101010101010111110111
1010000000001000000000000000000000101000000010001
1011111010111110101111111111111010101111111110111
1000000010100000101000000010000010100010100000001
1110111110111010111110111110111111101010101111111
1000001010101010001000000000000000101010001000001
1010101011101011101111101110111010101111101110101
1010101000000010001000001010100010000010100000101
1110111110111111101111111011101111101110111011111
1000101000001000000010001010000010000010001000001
1010101111111110101110111010101111111011101010111
1010001000000000100000101010101010101000001010001
1011101011111111101111101010101010101010101010111
1010000000101000001000001000100010101010100010001
1010111111101111101010111011111110101011111010111
1010001000000000100010100010100000100000101010001
1010101110111110101111111010111110101111101110111
1010101010100010001010000000001000000000100000001
1011111010101111111011101011101111101110101111101
1000100010100010000000101000101010100010100000101
1111101110101111101011101011101010101110111110101
1000000000000000101000001000101000001000100000101
1111111111111111111111111111111111111111111111111
