1111111111111111111111111111111111111111111111111
1000000000001000001000001000100000001000100000001
1111101111101011101011101110101011111010111111101
1000001010000010001010100000101000000010100000101
1011101010111110101010111110101111111010101110101
1010101010001000100000001000100000100010001000101
1010101010101111111111101111101011101111111011101
1010001010100000000000101000101010001010000010001
1010111010111111111110111010111010111010111110101
1010100010100000001000100010000010001010100000101
1011101110101111101011101111111111101010101111101
1000100010100000100010001000001000100010000000101
1110101010111110111110111011101010111110111111101
1010001010001000100010001010101010001000101000001
1011111111101011101011101010101011101011101011111
1000000010001000101010001000101000101000100000001
1010111011101110101110111110101110111110111111101
1010001000000010000000100000100010000010100000101
1111111111111011111111101111111011101010101110101
1000000000100010000000001010001000001000100010101
1011101110101110111111111010101111111111111010101
1010001000101010001000000010100000101000001010101
1010111011101011101111111010111110101010111010101
1010001000101000100000000000100010101010000010101
1010111110101110101111111111101010101011101110101
1010000010001000101000001000101010000010001000101
1111101111111011101110101110101111111111111011111
1000001000000000100000100000001000100000001000001
1011111011111110111110111111111010101111101110101
1010000000001000100000100000100010101010001010101
1011111111111011101111101110111010101010101010101
1000000010000000100000101000100010001010101000101
1110111010111110111110101011101111111011101111101
1000101000100000100010101000100010000000100010001
1011101111101111111010101111101010111110111010111
1000001000101000100010100000001010100010100010001
1111101110101011101011111111111010101010101110101
1000100000100010001010000010001000001010101000101
1110111111111110111010111010101111111011101110101
1000000000100000001000100000101000001010001000101
1011111110101111101111111111111011101010111011101
1000000010101000001000000010100010001010000010001
1111111010101110111011111010101011111011111110111
1000000010100010101000001000101010000010000010001
1011111111111010101010111011101010111110111110101
1010000000000010001010100010001010001010000010101
1010111111101110111010101110111011101011111010101
1000100000000010000010100000001000001000000000101
1111111111111111111111111111111111111111111111111
