1111111111111111111111111111111111111111111111111
1010001000100000001010001010101000001010000010001
1010111110101111111010101010101011101011111010111
1000000000101010001000100010000010001010000010101
1111111110101011101110111111101111101010111010101
1000100000100000001010001010001000000010001010001
1110101010101010111011101010111110111011101010111
1000101010101010001010000000001000101000001010001
1011111011101111111010101010111010101111111011101
1000100000100010101000101010001010001010001010001
1010101010101010101111101111111111111010111011101
1010001010001000001010101010101000001000000010001
1011111111111111111010101010101010101111101110111
1000100010000010001000100000100010101010100010001
1110111011101110101110101010111011101010101110111
1000000010001010101000001010000010001010100010001
1011111010111010101110111111111110111010111010101
1000100010000010101000001000001000001000000000101
1011101110111010101111101010101010101111101111101
1000100000001000101000001010100010101000000010001
1011111111111111111011101011111110101110101111101
1000000000000010001000101010000000101000100010101
1010111010101010101110111011101010101010101110101
1010100010101000101000001010001010101010100010001
1110111111111111111110111111111111111111111110111
1010100010100010101010001010001000000000100010001
1010101010111010101011101010101111101111111010111
1010001010100000001010000000101010001010100010001
1010111110111010111010111011111010111010101111101
1000000000000010001000001000001000000000100010001
1110111111111111101011101110101011101110111010111
1000100010000010000010001000101010001000100010001
1010101011101110101011101110101011101011101110111
1010101010000010101010001000101010001000100010001
1010111010101010111010101011111111111011111011101
1010100000101010001010101000000010001010000010101
1010111010111110111011101011101010111010111010101
1010000010000010001010001010001000000000100010001
1111111111101111111111111111111111111111111111101
1000001000000010101000001000101010001000101010001
1010101011101110101010101011101011101110101011101
1010100000100010100010100000001010000000101010001
1110111010111010111111101010101011101011101010111
1000101010100010100010101010101010001000001010001
1010101111111010101010101011101011111110101010111
1010001000000000001000001000101000100000100010001
1110111010111010101110101011101010111010101010101
1000001010100010100010101000100010000010101010101
1111111111111111111111111111111111111111111111111
