1111111111111111111111111111111111111111111111111
1000000000000000000000000000000000000000000000001
1011111111101111111110101111111010101011101111101
1000000000100010000000100010000010101000100000101
1011101011101111111010101010101010111110101010101
1010001010001000000010101010101010001000101010101
1011111011101111101110101110111110111110101110111
1000001010000000100010100010001000001000101000001
1111101111101110111111101111101110101110101110111
1000001000000010100000000000101000100010101000001
1010101110111111111110111010111011101111101111101
1010101000000000000010100010001000100010001000001
1110101110111010101011111011101111111110101110101
1000101000001010101000001000101000000000100010101
1011101011111111111010101110111011101111111010101
1000101000000000100010100010100010000000001010101
1110101011111010111011111011111011101110111110101
1000101010000010100000001010000000100010100000101
1011111011101011101011101110101011111110111111111
1000100010001010001010000010101000100000000000001
1011111110111110101011111111101011111010111011101
1010000000100000101000100000001000001010001010001
1010101011101010111111101011111010101111101111101
1010101010001010100000001010000010101000000010001
1011111110111111101111111010101011101010111011101
1010000000001000000000001010101000101010100010001
1010101011111011111111101111111011101010111111101
1010101000100000000010000000001010001010000010001
1010111011101111111111101111101111101110111111111
1010100000100000000010000010000000100010000000001
1010101010111010111111101110101011111011111111111
1010101010001010000010000010101010000000000000001
1111111011101010101010101111101110101110111010101
1000000000101010101010100010000010101000100010101
1010101011111011111110101011101010101011101110101
1010101000001010000000101000101010101010001000101
1110111111101011111010111011101011101110101010101
1000000010001000100010001000101000100010101010101
1010101011101010101110101111101010101011101010101
1010101010001010100010100010001010101010001010101
1110101011101010101111111010101011101110111011101
1000101010001010100000001010101000101000001010001
1111111011111011111011111010101011111111101110101
1000000000001000001010000010101000001000000010101
1010101110111111111110101010111110101111101110111
1010100010000000100000101010001000100000101000001
1011101011111110111111111010101010111011111110101
1000101000001000000000001010101010100000001000101
1111111111111111111111111111111111111111111111111
