1111111111111111111111111111111111111111111111111
1000100000000000100000000000000000000010001000001
1010101111101110111110111111101111111010111010101
1010101000100010000010100000100000100000100010101
1011101110111011111011101110111110111110101110111
1010001000001000101000100010000000100010101010001
1010111011111110101110111011111111101010101011101
1000100010000000100010001010000000001010100000101
1011101110111111101011101010111111111010111110101
1000101000101000001010001010000010001010001000101
1110101011101011111010111011111011101011111011101
1010101010001010100010100000000000001000000000101
1010101011101010101110101111111111111111111110101
1010001000101000100000101000000000001000000010101
1010111110101110111111111011111111101011111011101
1000100000100010000000001000001000100010000010001
1111101111111011111111101011101010111110111110101
1000001000000010000000001010001010100000100000101
1011111010111110111111111110111010101111101111101
1000001010000010001000001000100010001000001000101
1011101110111011101110101011111011111011111010101
1000100010100000100000100010001000001000101010001
1011111011101011111111101110101111101110101011111
1010000010001010000000001000101000100010101010001
1110111110111010111111111011101011111010101010111
1000100000101010000000100010101000100010101010001
1011101111101011111110101110101110101110101011101
1010001000000010100000100010001000100010101000101
1010111111101110101111111011111011111010101110101
1010000000100000100000001010000000100010100010001
1010111110101111111011111010111110101110111011101
1010001000101000001010000010000010101000001000101
1011111011111010111010111111111010101111101010101
1010001000000010000010000000001010101000101010101
1010101110111111111111111111101010101010101011101
1000100010001000001000001000001010001010001000101
1011111011111011101010111011111011111011111110101
1010001000100000100010100010001010000010000000101
1110101110101111111110101110111010111110111111101
1000101000101000000010101000000010100010000000101
1011101011101011111010101110111110101011111110101
1000101010001010001010100010100010001000100000101
1110101010111010101010111010101011111110101111101
1000100010100010101010100010101000000000101000001
1011111110101111101010101110101111111111101011111
1000001000100000100000101010100000001000001000101
1011101011111110111111101010111111101011101110101
1000100000000010000000001000000000001000100000001
1111111111111111111111111111111111111111111111111
