1111111111111111111111111111111111111111111111111
1000101000101010000010001010001010101000000000001
1110101110101010111110111010101010101110101111111
1000000000001010101000000000101010100010101010001
1110111111101010101011101010111010101110111010111
1010000000101000100000101010001010000010000000001
1010111110111011101111101111111010111110111111111
1010000010000010000010001010100000100000000000001
1010111111101111101011111010111011101010111011111
1010001000101000001010101000100010001010001000101
1010111010101111101110101011111010111111111110101
1010000010101010001010000000001000000000000010101
1010111011111011101010101111111110111111101011101
1000100010101010000000100000100000100010101010001
1011111110101011101011111011101110111010111111101
1000101010101000101010101010001010000010000010101
1010101010101011101110101110111011111110111110101
1010000000001010001000100000000000000000100000001
1110111111111011101011101110101110101110111010101
1000101010000000000000000010101000100010100010101
1011101010111111101111111111111111111110111011101
1010001010000010100010001000000010100010000000101
1010101010111110111110111011101110101110111111111
1010101000100010001000100010100010100010000010001
1011101011111010111110111010111110101111111110101
1010100000000000101010000000101010000010100000101
1010101111111110101010101111101010101110111011111
1000000010101000000000100000100000100000000000101
1010101110101110111110111111101110111110111111101
1010100010100010001010001000000010001000000000101
1011101110101011111011111011111111101111111111101
1010000000001010000000001010101010101010000010101
1111101111101111101111111010101010111010101110101
1000000010000000000000000000000010100010100000001
1111101110111111101110111110111110111010111111111
1000000010000010001010100000000000100000000000001
1110111110101010101011111110101011101111111111101
1000001010101010100000000010101010000000000010101
1011101011111011101011101110111110111111111110111
1000100010001000101000100010100000000010000010101
1011101110111010101110111011101110111110111110101
1000100000001010100010100000001000101000001000001
1011101010111111101110111110111110101011111110111
1010001010000010101000001010001010000000000000001
1110101111101110111110111010101010111111111110111
1000100000100000001000001000100010001000001010001
1011101111101010111110111110111010101010101011111
1010000010001010100000001000001010100010100000001
1111111111111111111111111111111111111111111111111
