1111111111111111111111111111111111111111111111111
1000000000101000100000000000100000001000100000001
1011101110101010101111111110111110101110101110101
1000100010101010001000001000100000100010000010101
1111111010101011111011101011101111111011111110101
1000100010001000100010001000001000001000001000101
1010101111111110101010111111111011101111101011101
1010101000100010101010000000001010100010001010001
1010101011101010101011111111101010101110111010111
1010001000001010101010000000001010100010100010101
1011111111111010101010111111111010111010101110101
1000100000001010101010000000100010001010100010001
1110101011111010101011101111101110111010111011101
1000101010001000101000101000100000100010001000101
1011101010101111101110101010111110101011101010101
1000001000100000101010101010000000101000101010101
1111101111101110101010111011111111101110101110101
1000101000101000101010001010000010101000100010101
1010111010101011101011101011101010101111111010111
1010000010001000100010001010001010100000000010001
1011111111111111111010111010111010111111111111101
1010000000100010000010001010101010000010000000001
1010111110101010111111101010101011101011101111101
1010001010001010001010001000101000001010001000001
1011101011111011101010111111101111111010111110111
1000101000100000101010000010000000000010100010001
1110101010101110101011111010111111111110101011101
1000100010101010100000001010100000001000101000101
1011111011101010111111101010101111101110101110111
1000000010001000001000001010101000100010000010001
1011111110111111111011111010101010111011111110101
1000000010000000001010001010001010100010000010101
1111111011111111101011101011111010101110111010101
1000001010100000001000001000000010100010101010101
1110101010101111101111101111111010111010101010101
1000101010101000001000100010000010100010100010101
1011111010101011111011111010111111101110111011101
1010001000101010000010000010000000100010001000001
1010101110101011101110111111111110111011101111101
1000101000101000001000100000000010001010001010001
1111101011101110111011101111111011101010111010111
1000001000101000100000101000000010001000100010001
1011101110101110101111101011111010101111111011101
1000100010100010101000001010001000100010000000101
1110111110111011101011111110101111111110101011101
1000100000100010001010000000101000000000101010001
1011101111101110111010111111101011111111101110111
1000000000100000001000000000100000000000100000001
1111111111111111111111111111111111111111111111111
