1111111111111111111111111111111111111111111111111
1000100010000010000000100000000000100000101000001
1010111011101110111011101110111111111110101111101
1010000010000010100000001000000000000000100000101
1110101111111011101110101011101110111111111011101
1010101010001000000010101000101000001000001010101
1011101010111111101111111010111110111110111010101
1000101010000010000000001010000010001000001000101
1110101010101111111110111111111110111010111010101
1000000000100000100000101000000010100010100010101
1111101011111111101110101111101011111011111110101
1000001000001000000010001000001010100000000010101
1011111011111111101111101110101010101011111110101
1010100000001010000000100010101000101000000000101
1110111110111010111111111010101111111111101110101
1000001000101000100010100000100010000000001000101
1011111011101011101110111111111111111011101111101
1000000010100010000000001010001000101000100000001
1111101110101111101110111010101011101010101111111
1010000000100010001000000000100000001010100010001
1011101110101110111011101110101011101011101110101
1010001000000000100010100010101010001010001000101
1011111010101110101010111011101111111010111110101
1000100010100010101010000000100000000010001010101
1011101110101111111111111010111110101111111010111
1010100010101000100000000010000010100010000010001
1010101111101110101011111110101010101110101010101
1000100010000010001010000000101010101000101000101
1010101111111011111111101011101110111111101010111
1010000000101000000010101010000010000010001010001
1010111111101110101110111111111111111011101110111
1010000010101000101000100010100000000000100010101
1011101010101110101110101110111011101110111110101
1010001010101000101010000000100010000010001000001
1011111110101111101010101010101010101110111011111
1000000000100010000010101010101010101000000010001
1010111011101011101111111011111011111011111110101
1010100010001000101000000010000000001000000000101
1110111110111110101010111011111011111111101111111
1000101000100010000010001010101000101000000010001
1011101111101110111110111010101111101010111110111
1010101000000010001000100000100000000010000000101
1010101111111010111010111010111110111110111011101
1000000010000010101010100010000010001000100010101
1011111110101010101110101011111011111110111010101
1000000010101010101000101010000010101000100000001
1011101110111010101011101011101010101111101011101
1010000010100000100010001000101000001000001000101
1111111111111111111111111111111111111111111111111
