1111111111111111111111111111111111111111111111111
1010000000000010000000001000000010000000100000001
1010111011111010111111111111101111101010101111111
1000101010000000000010001000101000001010101000001
1011101110111110101010111010101111101110101010111
1010001000101010101000100010101010101000100010001
1111101011101011101111111011101010111011101011101
1000000000100010001000000010000010100010101010001
1110111110101010101011111110111010111010101111111
1000001010101010100000001010101010000010000000101
1110101011101111101110101011101011101011101110101
1000100000100010001000101010001000001000101010001
1011111111101011111011111011101111111010101011101
1000000000101000001000100000101010000010001000101
1110111111111110101011111010101011111110101110101
1000100010100010100000000010100010100010101000001
1110111010111010101011111111101110101110111011101
1000001000001000101010100000101000100000001000101
1111111111101110101010111110101011101110101111101
1000001000000000101000100010000000000010101010001
1110111111101010111110101110101110111110111011101
1000000010001010000010000000100010100000100010001
1010101010111111101110111110101110111110101110101
1010101000000010101000100000100010001000100000101
1111111010111110111011111111101010111111101111111
1000100010001000001010000010101010101000100000001
1110111010111010111010111110101111101110111110111
1010101010001010100010001000000010100010001000101
1010101111101010111110101110111110111011101011101
1000001000101010001000100010001010001010000000001
1010101010101011111111101111111010101011101111111
1010101010000000101010101000001000101000100000001
1011101111101111101010101011111011111011111011111
1000101000100010000010001010101000001000100000001
1110111110101110111011101010101010111110101110101
1000000000000010001010101000100010001000000010101
1011101111111011111010101110101011111011111111101
1000101010101000100000001000101000000000100000101
1010111010101110101111101010111011101111111110111
1010000010101010001000000010100010101000001010001
1111101010101011101111101110111010111010111010111
1000101000001000000010000010001000001010000000101
1010111011111011101110111110101010111110111110101
1010101010101010101000001000101010000000100000001
1110101110101010111011111110111011101111111011101
1000000000000010001000100000001010100010000000101
1110111011111110101011101110111110111111101110101
1000100000000000101000101000000000001000001000101
1111111111111111111111111111111111111111111111111
