1111111111111111111111111111111111111111111111111
1010000010000010001010100000000000101000001000001
1010111011101111101010111110111011101010101010101
1000101000000010000010100000100000100010101010101
1010101010111011111010101011101110111011111111101
1010001010001010000000101000100010101000001000101
1111111110111110111111101011101111101111101110101
1010000000101010000000101000100000001000001000001
1011101011101011111110101111101011101011101011111
1000001000101010000000001000101000100010001000001
1111101110101011101111101110101111111110111110111
1010101000001010000000100000100000100000101000001
1010101110101011111111111110101010111011101011101
1000001000101010001000000010101010100000101010001
1111111110101010111011101010111110111110101011111
1000000000101010001000101010100000100000001000001
1110111111111010101011111010101110101110101111101
1000000000000010101010100000100010100010101000001
1011101110101011101010101111101111111110111111101
1000101000101000000000100000100000100000000000101
1111111111111111101111111111111111111111111110101
1010000000100010001000000000000010000010101000001
1010111010101010111010101110111010101010101010101
1000001010101010000010100010100010101000001010101
1010111010101110111111111111111111101111111110111
1010001010100010000000100010001010000000101000001
1110111111111010111111101111101010101110101110111
1000000000100010000000100000000010100010001000001
1010101010111010111111111111111010111111111111101
1010101010100010000000101000100010000000001000001
1011111111101110101011101011101111101111111011111
1000001000101010101000100000100010000000001000001
1011111011101011101111101111111011101111101011111
1000001000100010101000100000000010000000101000001
1011111010101110101110101010111011111011101011111
1010001010100000001010101010100010001010101000101
1011101011111010101010101111111110101010101011101
1000000000100010100000001000000010100000101010001
1111111110101010111111101110101010101110101010101
1000001000001010000000100000101000101000101000101
1110111110101111101111111111111111111111101111101
1000000000100010001010001010100010000010001010001
1010101011111010101011101010101010101011101010101
1010101000100010100000000000001010101000001000101
1111111111111111111111111111111111111111111011111
1000000010001000101000100010000000001000000010101
1011101010101010101010101110101011101011101010101
1010001000100010000010000000101000100010001000001
1111111111111111111111111111111111111111111111111
