1111111111111111111111111111111111111111111111111
1000100010000000000000100010000000000000000010001
1011101010111111111110101011111111111111111010101
1000101010001000000000001000001000100010000010101
1110101011111011111111111110101010101010111110101
1000101010000000001000000010100010101000000000101
1011101010111111101111101110111110101111111111101
1000001010100010001000100000001000000000100010101
1111111010111010111010111111101111111111101010101
1000001000100010100010000000001000001000001010001
1010111111101110111111111111111011101010111011111
1010001000100000100010000010001010001010001000001
1011101010101111101011111010101010111011111111101
1010100010100000001010001000100010001000001000101
1010101111101111101010101111111010111111101011101
1010100000001010001000100000100010100000001010001
1010111110111010111111111010101110101111101010101
1000101000100010100000001010001000101000001010101
1111101011101010101110111011111111101010111010111
1000001000001010101000100000101000001010100010001
1011111011111110101110101110101011111010101111101
1000001000100000100010101010100010100010100000101
1011101110101111111010101010111010101111101110101
1000100010101000100010100010100010001000101010101
1110111010101010101110111110101110111010101010101
1000100010101010101010001000101000101010001000101
1011101110101010101011101011101011101011111011101
1000100010100010000010101000101000001000101000001
1111111011111111111010101110101111101110101111111
1000001000000000001000101000100000100010000000001
1011101011111111101011101011111111111111111110111
1000101010000010001010001000100000001000000010001
1110101010111011111110111110111110101010111011101
1010100010101000100000100000000010101010101000101
1010111010101010101111101111101110111010101011101
1010001010100010100000101000101000100010101000001
1010111010111110111110101110111011101110101111111
1000100010000010001000100010100000001010100000001
1111101111111011101011111010101110111010111111101
1000001000001000101010001010001000100010001000001
1011111011101110111010101011111010101111101011111
1000001000100010001000101000000010101000100010001
1111101110111011101111101011111110101010111111101
1000100010001000000010001000000010100010100010001
1010101011101111101010111111111010111110111010101
1010001010001000001010000000100010000010000000101
1011111011101011111011111110101111101111111110101
1000001000001000001000000000100000100000000000101
1111111111111111111111111111111111111111111111111
