1111111111111111111111111111111111111111111111111
1000001010101010000010100000100000000000101000001
1010111010101010111110111011101110111111101110111
1010001000101000101010100000101010101000000000001
1111101011101110101010111011101011101011101010111
1010000000001000000000001000000000000000101010101
1011111111101111111011101010101011111010111111101
1000000010001000100010001010101000100010100010001
1111111011101011111111101010101111111010111010111
1000100010000000101010000010100000100010001000001
1110111010101110101011111011111011111111111011111
1010100000101010101010000000100010000010100010001
1010101010111010101011101110111110111010101110111
1010001010100000101010000010001000001010100010001
1011111111111110101010111110111110111110101010111
1000101000101000000000001000100010101010001010001
1011101011101111111011111110111010101010111110111
1010001000100000100010000010001010100010100000101
1010111010111011111010111111111010101110101111101
1000101010100010000000100000101000000000000000001
1011101110111010111010111110101111101110111011111
1010001000100010100010101010001010101010100010001
1011101110111011111011101010111010101010111010111
1000001010001010101010000000000010001010100000001
1110111010111010101010101011101111101011111110111
1000000000000010000000101010000010000000101010001
1110111110111011111110111111111110111010101011101
1000101010101010101000100010000000100010100000101
1011101010101010101110101011111010111111101011101
1010001010100010101000001010100010000010101010101
1011101011101010101110111110111011111110101110111
1010000000001000101000000010000000000000000000001
1011101011111110101110111010111011101111111111111
1010101010000000000000001000101000101010101000101
1110101111111110111110111011101010101010101110101
1000100010100000100000001000001010100000000000001
1110111010111111111110101111101111111011101110111
1000100010001000101000100000100000100010001000101
1110111110111110101110111010111110111011111110101
1000000010000000000000001010001010101000100010001
1110111010111011101010111111111011101011101111101
1000101000001010001010000000000000100000000010001
1111101011111011101011101011111110111010111110101
1000101000100010001010001000000010101010100010101
1110101010111011111011101010111010101011101111101
1000000010001010101000101010001010100000000000101
1011101110111110101110111111111011111010101011101
1010000010001000000000000000100000001010101010001
1111111111111111111111111111111111111111111111111
