1111111111111111111111111111111111111111111111111
1000100000000010000010000000100000100000000010001
1010101011111010101110111011101010101111101010101
1010001000001010100000001010001010100000101010101
1011111111101011111110111010111010111110101010101
1010001000001000000010100010100010001000101010101
1011101011111111111011101110101110111011101011101
1000001000100000001010001000100010100010101000001
1111101110101011111010111011111010101110101111111
1000100010101000100010000000001010101000100000001
1110111010111010101110111111111010101010111111101
1000100010001010001010001000000010101010000000101
1011101111101011111010111011111011101111111011101
1000001000101000100000100010100010001000000010001
1011111110101110111111101110101110111011111010111
1010000000101000100000001000101010100000001010101
1010111111101011101111111011101010111111101010101
1010000010001000001000000010001010000000001010101
1011111010111111111011111010111011111110111110101
1000000010100000001000100010100000000010100010101
1111111010101111101110101110101111101110111010101
1000000010000010001000100010100010100010001000101
1011111111111110111010111110111010111011101111101
1010000000000000100010100000101000001000101000001
1010111111111111101110101111101111101011101111101
1010001000000000001000101000100000001000100000101
1011101011111111111111101010111110111110111110101
1010001000100000100000001010000010001010001010101
1010111010101110101111111011111011101010101010101
1010101010000010001000000010001010001010100010001
1010101011111111101111101110101011101010101111101
1010100000100000100010001010101000100010101000101
1010111110101110111010111010101110111110101010101
1010000010101010100010100000101000000000101010101
1011111010101010101110111110101011111111111010101
1010000010100010100000100010100010000000000010001
1010111111111010111110101011111110111111111111111
1010000000100010100000101000100010000000001000001
1011111110101110111111101110101011111111101111101
1000001000100010000010001010001000001000100010001
1011111010111011111010111011111011111010111010111
1010000010001010001010000000001000000010000010001
1010111111111011101011111111101111111111111111101
1010000000100010001010000000100010000000001000001
1011111110101110111010101111111011111010101110101
1010000010001000100010101000001000001010100000101
1011111011111010101110101011101111101110111111101
1000000000000010100000100000100000000000100000001
1111111111111111111111111111111111111111111111111
