1111111111111111111111111111111111111111111111111
1000100010000010100010001000000000000010001000001
1010111010111010101010111010111111111110101011101
1010000010101000001000001010100010001000101000101
1011111110101111111011101010101010101011101010101
1000000010001010001000101010001010101000101010101
1110111011101010101110101111101010101111101011101
1000101000001000100010100000001000101000101000101
1011101110111111111010111111111111101010101110101
1000100010001000000000100000001000001010101000101
1110101011101011111111101111101011101010101011101
1010101010101010001000100010001000101010101000101
1010101010101010101110111010111110101010101110111
1010101010001000101000100010100010101010001000001
1010111010111111101010101111101011101011111011101
1000001010000010100010100000001000100010001000101
1111101011111010101111101111111010111010101111101
1000100010001000101000001000100010001000100000001
1011111110101110101011111110101111101111111111101
1000000010100010100010000000101010001010001000101
1110111110111011111110101111101010111010101010101
1000000000001010000000100000000010001000100010101
1011111111101010111111111011111111101111101110101
1010100010101010000000100010001000100010000010001
1010101010101011111110101110101010111010111111111
1010101000001000001000100000101010000010000000001
1010101111111111101111111111111011101111111011101
1010001000100000001000000010000010001000001010001
1010101110101111111011111010111111101111101010111
1010100010000000001000100010000000100000101010001
1011111111111111101010111111111110111011101010101
1000001000000000001010000000000000101010001010101
1110101011111111101111111111111011101010111010111
1000101010000000001000001000100010001000001010001
1011101010111111111010111010101110101111101110101
1010001010000010100010001010001000101000001000101
1110111011111010101111101011111011101011111011111
1000100000001000101000101000001000101010001010001
1011101111111111101010101110111110101011101011101
1010001010000000001010001000100000101010001000001
1110111010111111111011111111101111111010111110111
1000000010000000001000000010001000100010000010101
1011111111101110111111101010111010101011101110101
1000100010001000100010001010100010001000001000101
1010101010111111101010111010101011111111111011101
1010101010000000001010100010001010001000001000001
1010101011111111111010101111111010111011101011101
1010001000000000000010100000000010000000100010001
1111111111111111111111111111111111111111111111111
