1111111111111111111111111111111111111111111111111
1000000000000000000000000000000000000000000000001
1011101110111111101011111011111111101110111010111
1010000010000000101010000000000000100010001010001
1011111111111111111110111110101110111110111010101
1000000000000000000010100000101000001000001010101
1010111110101110111110101111101110101110101010101
1010001000100010100000100000100010101000101010101
1011101011111110111010101111101011101110101010101
1010001010000000001010100000101000101000101010101
1011111111111111101111101110101010111011101010101
1000000000000010001000001000101010001000101010101
1110111011111110101010111011111111111111111111111
1000100000100000101010001000000000000000000000001
1010111011101010111111101011111111101111111011101
1010100010001010000010001010000000000010000000101
1010101010111111111110111110101011101010111010101
1010101010000010000000000010101000101010001010101
1110101011101010101111101111101010111110111110111
1000101000101010100000101000001010001000000010001
1010101110111010101111101110111011101010101111111
1010100010001010101000001000001000101010100000001
1010111110101110101110111011111110111111101011101
1010001000100010100010100000100000100000001000101
1011111010101010101110101110101011111010101011101
1010000010101010100010101000101000001010101010001
1110111010111111101111111011111011111011101011101
1000100010100000000000100000001010000000101000101
1011111111111011111011111110101110111111111110111
1000000010000000100000000010100010100000000000001
1010101010111011101011111010101011111110101111111
1010101010100000101000001010101000001000100000001
1010101110101011111110111011111111101111111011101
1010100010101010000000100010000000000000100000101
1010111010111110111011111010101111101011111010101
1010100010000010001000001010101000001010000010101
1010111011111110111111101110101011111011101011111
1010100000000010100000000010101010000010001000001
1011101110101011111110101110101110101010111110111
1010001000101000001000100010101000101010000010001
1011111011101011111111101110101011101010111011101
1000100000101000000000100010101000101010001010001
1110111010101111111010111011101010101011101111101
1000001010100000001010100000101010101010000000101
1111101110101010111011101010111011101010101010101
1000001000101010001000101010001000101010101010101
1011101010111110101011111110101110101110101010101
1010001010100000101010000000100010101000101010101
1111111111111111111111111111111111111111111111111
