1111111111111111111111111111111111111111111111111
1000100000000000100000100010000010001000000000101
1011101111111110101110101110111010111011111010101
1000101000001000100010100000100010000010000010001
1110101011101011111010101111101011111110111111111
1000101010001000100010101000101000001000100000001
1011101010111110101110111010101111101011101111101
1000001010000010001010100010001000001010000000101
1011111011111011111010101111101110111011111110111
1000001000100010000010001000001000101000001010001
1111101111101110111111111011111011101011101011101
1000001000000000000000101010000010100010001000001
1011111011111111101110101010111110101111101110101
1010000000100000101000100010000010000000100010101
1010111111101110111011111111111011111110111011101
1000101000100010100000000000001000001000100000101
1111101010111010101011101111111111101011101110101
1000100010000010101000101000100010100010100010001
1011111111111110101111101010101010111110111111101
1000000000100010100000100010001000000000001000001
1110111110101010111110101111111111111111111011111
1010101000101000000000101000100000000000001000001
1010101011101111111111111010101111111111101111101
1000101010001000001000001010001000000010100000101
1011101010111010111011101011101011111010101110101
1000001010100010000010001010101000001010101000101
1110111010111111111110111010101111101010101111101
1000100010000000100000100010000010001000100000101
1111101111111010101111101111111010111111111010101
1000000000000010101000100000001010000010001010001
1011111111111110101011111111111011101110101011101
1010000000001000101010000010000010001000101010001
1010111111101111101010101011111110111011101011101
1010001000001000001000101010000010001010001000101
1011101011111011111011101011101011101010111110101
1000101010000010000010001000001000100010000010101
1110101010111110101110111110111111111111111010101
1000101000100000101000101000101000000000100010101
1011101111111011101111101011101011111011101110101
1010001010001000100010001000001010100010001000101
1010111010101110111010101110101010101110111011101
1010100000100010101010100010101010100010000010001
1010111110111010101010111010111010111010111110111
1010000010001000101010001010100010001010100010001
1011111011111111101011101010101111101010101011101
1000000010000010000010001000100000101010101000101
1111101110111010111011111111101011101011101111101
1000000010001000001000000000001000001000000000001
1111111111111111111111111111111111111111111111111
