1111111111111111111111111111111111111111111111111
1010100010101000101000100000000000001000000000001
1010101010101110101011101111101110111110111011111
1010101010000010100000000010000010000000001000001
1010111011111010101111101010101110111110111111111
1000000010000010001000101010101000000010100010101
1111111011111010101011111111101011101010111010101
1010100000000000100000100010101000101010101000001
1010111111101110111011101110111111101011101011101
1000000000000010001000000000100010101000100000101
1010111110111110111111111110101110111011101111111
1010100000100010100000001000000000001000000000001
1010111110111010111010111111101110111010111111101
1010100000001000000010000000101000001010100010001
1011111010101111101011111110101111111011101111111
1010000010101000001000100010100000001000000000001
1011101110111110111110111011111111111110101010111
1000101000001000001000000000000010001010101010001
1110111110101110111110111111111111101011111110111
1010101000100010000010101000000000000000101010001
1011101110111011111110101010111110101110101011111
1000000000001010001000100010101010101010001000101
1010111010101011101110111011101011111010111011101
1010001010101000100000000000100000000010000000101
1111111011101110101110111011101110101010111011101
1000000000100010101000100000000010101010100000001
1011101111101010111011111010101010101110111011111
1010100010001010100000100010101010101000100010101
1010111111101110101011111010111111101111111010101
1010000000000010101000100010100010100010000000001
1011101110101010111011111011101110111011111010101
1000101000101010100000001000000000100000001010101
1110111010111110111011101110111111111010111110101
1000101010100000101000101010100010001010000010101
1111101010111011101011111011101111101111111110111
1000000010100010000000000000000010000010100000001
1111111010111011101110111010101111101110111110111
1000000010100010100010001010100000000000000010001
1011111010101110101110111111101111101111111110101
1010000010101000001010100010001010100000000010101
1111101011111110101011111011101010111010111011111
1010101010000010100000000010000000001010101000001
1010111111101010111011101111101110111111101010101
1000000000001000001010000010001010100000100010101
1010111110101010111110111111101011111110111111101
1010001000101010000010000010000000100000100010101
1011101110101011101110111110111010111011111010111
1010001000101010000010100000001010000000000000001
1111111111111111111111111111111111111111111111111
