1111111111111111111111111111111111111111111111111
1000001000100000000000100010001000100010000000001
1011111011101111111110111010101010101010111111101
1000001000000010000010001000100010001010001010001
1011101110111110111010101111111111111010101010111
1000100000100010001000100000000000000010100010101
1110111011111010101111111111111011111110111110101
1000100010001010101000001010001000100000100010001
1011111110101011101011101010111110111110101011101
1010000000101000100010000010000010001000101000101
1010101111111010111111111011111011101010101110101
1000100000100010001000001010001000100010001000101
1111111110101111101011101110101110111111111011101
1000000000100010001000101000100010100000001010001
1011111110111110111110101011111010101111101011111
1000000010000000101000100000001000100010001000001
1111111011111111101011111111111011111011111111101
1000001000100000101000100000001000100010001000101
1011101110111010101110101111101110101110101010101
1010001010000010100010001000100010001000100010001
1010111011111110111010111010101010111011111111111
1010000010000010001010000010101010000010000000001
1110111110111011101011111110101011111110111110101
1000100010101000100010000010101000000010001010101
1010101010101110111110111011101011111011101010101
1010001000100010001000100000101010000010001010101
1010111111101111101011111110101010111110101010111
1010100010100000101000001000101010100010101010001
1011101010111010101111101011101110101010101011101
1010001010000010001000001010001000101000101010001
1010111011111111111011111010111011101011101010111
1000100000000000100010001000100010001010001000001
1011101111111110101011101111101110111110111111101
1010000000001000101010001000100010100000100000101
1110111111101011101010111110111010101111101111101
1000100000101000001010000000000010101000101000001
1011111110101111111011111111111110101010101011111
1010000000101000001000100000000010101010001000001
1010111111101011101110101111111010101011111111101
1010100000100010000010001000001000101000001000001
1010101110111111111011111011101011101110111011111
1010100010000000001010001010100010001010001000101
1010111011111111101011101010111111111010101010101
1010100000100010001010001010000000000010101010001
1010111111101010111010101011111110111010101011101
1010000000001000100010101010000010100010101010101
1011111011101110101110101010111010101111101010101
1000000010001000100000101000001000100000100010001
1111111111111111111111111111111111111111111111111
