1111111111111111111111111111111111111111111111111
1000001010001000000000100010100000100000100000001
1011101011101010111010101010111110111010111011101
1010000000101010100010001010001000001010000000101
1111101110101110111011101111101011111111101011111
1000100010001000001000100000000000000000001010001
1011101011101011111111101110111110101111101111101
1000101010001000001010001000000010101010000010101
1110101011101011101010111010111111101011111010101
1010001010100000101010001010001000101000100000001
1010101010101111101011111011101011111011111111101
1000101010100010101000001010000000001000000000001
1111101010101010101010111110101111111110111011111
1000001010001000100010001010100000000010101000101
1111111011111011111011111010111111111010101110101
1000101010100000100010000010100010001010100000001
1010101110101010101110101111111010101011111111111
1010001000001010101000101000000000100000001000001
1111101110111111111010101011111110111011101111101
1000000000000010000010101000001010101010100000001
1011111010111110111110111110101011101110111111101
1000001010000010000010100010100010100000001000001
1011111111111110101111111011101010111011101110111
1010000000001000100010000000001010100000101010001
1010111011111111111010111111111010101111111010111
1010001010100000000010001010001010100000100000001
1011101110101110111010111011101010111110101011111
1000000000000010101010100000001000001000001000001
1111111111111011101111111011111110111011101011101
1000100000101000001010000010000000101000101010001
1110101110101110101010111110101011101011111111101
1000100010001000101010000000101010100010001000001
1110101111111110111011111110111010111010101111111
1010100000101010001000100010001000100000101000001
1010111011101010101110101011101111111110101011111
1010000000000000101010001000000010100010101000101
1011101011111011101011111110111110111010111011101
1000101000100000100010001010100010001010000000001
1110111110101111111111101010111010111010111110111
1000000010100000101000001000100010000000001010001
1011101011111011101011111010111011111010111011101
1000101000100010100000101010000010101010001010101
1111101110111010111011101111101110101010111010101
1000000010000000101000001000101010000010100000001
1010111111111010101010101010101011111011111011101
1010100000000010001010100010101000100000001010001
1110111010111010111110101111101110111010101110101
1000001010100010000000100010000000100010100010101
1111111111111111111111111111111111111111111111111
