1111111111111111111111111111111111111111111111111
1000100000000010101010101010101010001010100000101
1110111011101110101010101010101010111010111110101
1000001010001010000000101000101000100010101000101
1110101111101011101010101110101011111010101110101
1010101000000010001010101010000010001000001000001
1011101110101111101111101010111110111111101110101
1010000010100000101010000010001010101000000000101
1011101111101111101011101110101010101110101010101
1010000000101000000000101000101010000000101010101
1011101111101110111111101011111011101110111111111
1000000000100000001000101000001000000010000010101
1111111110101011111110101011111110111111101110101
1010101000001010001000101010001000000000100010001
1010101110111111101110101011101110111111111111101
1010000000001010001010000000101000101000000000101
1010111010111011101010111111101110101110111110101
1000101010101000000010001010001010100010100010101
1111101110101010101011101011101010101110111011101
1000000010101010101010000010100010000000000010001
1110111010101110101111101010101110101010111110111
1010100000001000101010001000000010101010000010001
1011111011101011111011111010111111111011111110111
1010001010000010000010101010001010101000001010001
1010101111101110111010101110111010101011111010111
1010100010000010101010100000101010001000100000001
1011101111101110101110111110101011101011101110111
1000100010100000000000000010001000100000001010001
1010111010101011111111111110111011111011111011101
1010000000101000101010001010000000000000001000101
1110111011101111101010111011101111111110111011111
1010101010000000100000101010001000000010101000001
1011101010111011101111101011101011111111101011101
1010000000101010001010000010000000000000100000101
1011111110101111101011111010101011111111101111111
1010101000100010000010100000101010101000000000001
1010101110101110111110111010111110101010101011101
1000100000000010101010001010101000001010101010101
1110111111111010101011101110101110101011111010101
1010000000000000000010101010100010101010001000101
1011111011111010111110101010111010111010111011111
1010100000100010001010100000000000001000101010001
1010111111111110111010101111111011111011101110111
1000000000000000000000000000101000100000100010101
1010111010101110111011101011101011111011101110101
1010100010101000101000101000101000000000101010101
1010111111111011101010111110101110111010101010101
1010001000000010000010001000000010100010000000001
1111111111111111111111111111111111111111111111111
