1111111111111111111111111111111111111111111111111
1000000000000000000000000000000000000000000000001
1110101010111111101011111010111111111111111110111
1000101010001000001000100010000000001000000000001
1011101111101111111011111011111110111010111011101
1000101000000000001010000010000000001010100000101
1010111010111011101111101011111011111110111110101
1010001010100010000010001000001000000010001000101
1111101111101010101110111011101011111111111011101
1000000000101010101000001010001000000000100010001
1011101011111110111110111011111010101110111011101
1000101000001000100000001010000010100010001010001
1011101010111011111110111010101110101011101110101
1000101010100010000000100010101000101000100010101
1110111110101111111111101110111011111011111010101
1000000010101000000000000010100010000000001010101
1010111010111010101010111111101010101010101110101
1010001010001010101010001000001010101010100010101
1011111110111011111111101110101110101011111111101
1000000010100000001000001000100010101010000000001
1110101011111110111110101011101010101010111010101
1000101010000000001000101010001010101010001010101
1010111011111010111111101111111111111110111110101
1010001000100010001000001000000000000000100000101
1011101110101010111011111010111010111111101111111
1000100010101010001000001010001010000010000000001
1011111010101011111010101110111110101010111110101
1000001010101000001010101000000010101010100000101
1110111010111111111110101010101110101011111011111
1000001010000010000000101010100010101000100000001
1011101010111011111110111110111011101111111011111
1000101010100000001000000010100000100000100000001
1011101111101010101110111011111011101110111011101
1010001000001010101000001000001000100010100010001
1011101110111011101010111111101010111010101011101
1010001000100000101010001000001010100010101000101
1010111111111110111111111111101110111111111110101
1010000000000010000000100000001000100000000000101
1111101111111011111011111110101011111110111110101
1000000000100010000000000010101000001000001000101
1010101111111111101010101111101110111111101111101
1010100000100000001010100010001000001000000010001
1110101110101011101111111011111010111011101111101
1000101000101000100000001000100010100000101000001
1010111010111011111110101010101110101111101111101
1010100010100000000010101010100010100010000000101
1011111011101111101010101110101010111110111010101
1000100010000010001010101000101010100000001010101
1111111111111111111111111111111111111111111111111
