1111111111111111111111111111111111111111111111111
1000000000000000000000000000000000000000000000001
1010111111111011111010111010101110111011101010101
1010000000001010000010100010100010100010001010101
1011111110101011111110111011101011101111111111101
1000001000101010000000100000101000100000000000101
1111101111111110111111101111111011101111111010101
1000000000100000100000000000001000100000100010101
1110101110111111111011101010101011111011101010111
1000101000100000000010001010101000100000101010001
1110111110111011111010101011111011111011101110101
1000000010001000001010101000100000100010000010101
1011101111111011101011101110111110101010101111101
1010000000001000101010001000001000101010100000101
1010101110101010111011111011101111111010101010101
1010101000101010100010000000100010000010101010101
1011111010111011111110111010111011111110101011101
1000001010100000100000001010100010000000101000101
1010111111111110101010101010101010101010101010111
1010100000000000101010101010101010101010101010001
1010111010101111111010111010111011111111111010101
1010001010100010000010100010001010000000000010101
1110111010111111101111101111111111101010101011101
1000001010000000100000101000000000001010101010001
1011101111101011111110111011111110111011101011111
1000100010001000000010001000100000100010001000001
1110111111101111101111101011111110101011111111101
1000000010000010000000101000000010101010000000001
1110111011101010111011111110101010111011101011111
1000001010001010100000000010101010001000101000001
1011101111111110111010111010101110101110111010101
1000100010000000001010100010101000101000100010101
1010111010101011111011101011101110101010101011101
1010100010101010000000101000100010101010101010001
1110101111111110111111101111101111111010101110101
1000100000100000100000000000101000000010101000101
1010111110111111101110111011111010111110101111111
1010001000001000000010001000100010000010100000001
1110101110101010101110101110101010111011101111101
1000101000101010101000100010101010001000101000001
1010111110111010101110101011111111101111111010111
1010100000001010100010101000000010000000001010001
1011111010111110101010101011101010111010101110101
1000001010000010101010101000101010001010101000101
1010111011111110101110101111111111101011101110101
1010100010000000100010100000000000101010000010101
1010101010111011101011111011101111101011101011111
1010101010100010001010000010001000001000101000001
1111111111111111111111111111111111111111111111111
