1111111111111111111111111111111111111111111111111
1010001000100000100000000010101010001000100000001
1010111011111011101111111110101010111011101010101
1000000000001000000000000000000000001010001010101
1111111110111110111111101111111111111010101110111
1010101000100010101000101000000010000000101000001
1010101110111010101010111110111110111110111111111
1000001010100000001010101000101000001010000000001
1110111010111011111011101110101010101011111111101
1010101000100000100000000000000010101010100000101
1010101110101110101011101110111011111010101011111
1000000000101000001000101010001010001000101010101
1110111110101110101111111011101011101011101110101
1000101000000010100000000000101010001010100010001
1111101110111110101111111111111111101010101110101
1000000000000010100000000000001000100000000000101
1011101110111110101010101111101010101010101011111
1010000010001010101010101010000010001010101000001
1111101110101011111011101011111011101111111010101
1010100010100000001000100000100000100000001010101
1010111010101011111111101011111011111011111010101
1000001010101000000000101000100010100000101010101
1011101010111010111011111111111010111111101111101
1010000010100010101000000000001000101000100010001
1111101110111111101111111011101110101011101111101
1000001000000000000000001000100010000000001000101
1010101110101111101010111010101110101110101011111
1010101000100010101010001010101000101000100000001
1010101011101110101111101111111110101010101010111
1010101010000000100010000010100000101010101010001
1110111111101111111111111110111110111111101111111
1000000010000000000000101000001010100000000000001
1110111110111011101111101011111011111110111110111
1000001010100000100000100000000000000010000010101
1110111010111010111111101110101110111010101111101
1000000010001010000000100010100010001010101010101
1110101110111010111011101111111111111110111010101
1000101000100010100000000000001010000010000000101
1110101110101011111010101011101011101111111010101
1000101000101000100010101000100000001010101010101
1110111110111111101011111110111111111010101111101
1000000010000010001000000010001010100000101010001
1110111011111111101011111110101010101111101011101
1000001000001000001000100010100000000000000000001
1110111011111110111011101011101111111011111110101
1000001000100000001000001010000000101000001010101
1110101010101010111111111110111011101010101010111
1000101010101010000000000010001010000010100010001
1111111111111111111111111111111111111111111111111
