1111111111111111111111111111111111111111111111111
1000000000000000000000000000000000000000000000001
1111101111111011111010101111111111101010111110101
1000001000000000100010100000100000001010000010101
1011101111111110111011101010111110101110101110111
1000101000000000001010001010000010101000101000001
1110101010101011101011111010111010111010101010101
1000101010101010001010000010001010100010101010101
1011101110101010101111111011111010111010111010111
1010000010101010100000100000100010100010001010001
1010111010111111111111111010111010101010101010111
1010001010000000000000100010100010101010101010001
1011101111111110111111111011111011101110111011101
1000100010000000000000100000001000100010100010001
1011101110101111101011101110111110101011101111101
1000101000101000001010000010100000101000100010001
1010101010111110101011101110101110111010101110111
1010101010000010101000100010100010001010101000001
1010111011101011111010101111101011101111101110101
1010001010001010000010101000001010001000000010101
1111111011111011111011101110111110111110111011101
1000000000100000001000101000000010001000100010001
1010111011101111111011101010101011101110101011101
1010001010000000100000101010101000100010101010001
1110101011101110111010111110111010101010111010101
1000101000100010001010100000100010101010100010101
1110111010101110111110101110111111111111101010101
1000001010101000000010100010000000000000101010101
1010101010111111101011111111111011101010111110101
1010101010000010001000000010000000101010001000101
1011101111101010101010101011101110111110101011111
1010000010001010101010101010000010001000101000001
1010111010101011111010111110101111101110111111101
1010001010101000001010000010101000000010100000001
1010111110101010111010111111111110111111101110101
1010000010101010001010100000000000100000000010101
1010101010111011101111111010111011101110111010101
1010101010100010000000100010100000101000001010101
1011111010101110101011101111111111111011111111111
1010000010101000101000100000100000000000000000001
1011101011101111111011101010111110101011101011101
1010001010000000100010001010000010101000101000101
1010111011101111111111111011101011111111101011101
1010001010000010000000000000101000000010001000101
1010101111101011111111101111101110101111111010101
1010101000001010000000000000100010100000001010101
1011101011101111111111111010101010111111101111101
1000101010001000000000000010101010001000001000001
1111111111111111111111111111111111111111111111111
