1111111111111111111111111111111111111111111111111
1000001000001010001000000000000000001000001000101
1011111011111010111110111111111111111111101010101
1000000000000010001000001000000010001000101010001
1111101011111011101010111010111010111110101110111
1000101010101000001010000010101000001000101000001
1010101010101011101011101011101010101011101111101
1010001000001010001010001000100010101000001000001
1011111011111110111011111111111011111011111011111
1000001000000010001000000000100000001000001000001
1110111111111111111111111110101110101110111111101
1010100010001000000000001000100010101010101000001
1010101010111011111110111010111011111010101011101
1000001000001010101000001010100010001000001010001
1110111010111010101110111010101010101111101010111
1000001010001000001010001010101000100010001010001
1111111111101110101010101010111011111010101011111
1000001000101000101000100010100010001000101000001
1010101110101110111011111111101010111011111011111
1010100000000000001000000000101000001000001000001
1011111010101110111111111111111110111011111011101
1000001010101000001000000000000000001000000010001
1111111111111111111111111111111011111111111111111
1000000000000000000010001010100000000010101010001
1111111111111111101010101010101110101110101011101
1000100000000010001000100010100010101010100000001
1011101111111010111111111010111010101010101111101
1000000010100010001000000010000010100000000010001
1011111010101111101111111011111111101111111111111
1000100000100010001000000010000000001000101010001
1011101111101110111110101010111110101010101011101
1000100000100000001000101010100000100010000010001
1011111111101110111011101010101110111011101011101
1000100000000010001000101010100010100000101010001
1110111111111111111111101111111111111011111110111
1000001000100010001010000010000000100000100000001
1011101110101110111010101011101111101111101010111
1000101010100010101000101010001010100010101010001
1011111010111010101010111010101010101110111010101
1000001000100010001010100010100010100000000010101
1110101110101110111111111010111110101111101111101
1000101000100010001000001010000000100000100010001
1111101010101111101011101011101111101010111010101
1000000010100010101010001010000000001010100010101
1111101111111010101111101011101111111111111010111
1000000010100000001000001010000010000000101010001
1010101110111011101110101010111010111010101010111
1010100000000010001000100000100000100010100010001
1111111111111111111111111111111111111111111111111
