1111111111111111111111111111111111111111111111111
1010001000100010100010101010001000100010000000001
1010111011101010101010101010101011111011111010111
1000000000101000001010001000101000100010100010001
1011101110111111101110111010111011101110111010111
1010001000100000000010001010001000100010100010001
1111111011101110111110111111101110101110111010111
1000001000100010100010001000100000100000000010001
1010101110111010101010111010101110111111111011111
1010100000100010001000001010001000101000000000001
1011111110111010111111101111111110101010101011101
1010001000000010000010001000001000101010101010101
1011101011111111101110111010101010101111101010101
1000001000100010001010001010101010101000001000101
1110111111101110101010111011111110101010101011101
1010000000100000100010001010100000101010101000101
1011101010101111111111101010101010101111101011101
1000001010100000000010001000001010100000001000101
1111111111111011111111111110111110111111101111101
1010101010000010101000001000001000000000000000101
1010101010101010101011111111111011111111111111111
1000000010101000101000001010101010001000000010001
1011111011111011101110101010101011101011101110111
1010001010001010100000101010100000001000100010101
1011101011101010111111101010111011101110101110101
1010100010001010100000001010001010000000100000001
1010101010111010101010111010101010111110101111101
1010001000000000001010001010100010001010100010001
1011111011111011101011101010101111111010101011101
1010000010100010101010001000100000001000101010001
1011101110101010111011111111111111111111111011111
1010000010001000100000001010001000001000000000101
1011111110111111101011101011101110111111111110101
1010000000000000101000100010001000001000100010101
1010111111111111111011101010101110101010101110101
1010000000000000100000101010101000101010000000101
1111111111111111101111111011101111101111111011101
1010100010100010100000001010000000100000000010101
1010101010111010111011111011101010101010101010101
1000001000100000001010101000001010001010101000101
1111111011111011101010101010101011111011111010101
1000000000100000100000001010101000001010100010101
1110101111101111101111111011101011111010111010101
1000100010101000101010001010001000001010000010101
1110101010101110101010101011101011111111111111101
1010101010100000100000101010001010000010000010001
1010101110111011111011111010101010101010101010101
1000100000000000100000001010101000101000101000101
1111111111111111111111111111111111111111111111111
