1111111111111111111111111111111111111111111111111
1000001010000010000000000000001010001010000010001
1010101011101111101111111010101011101010111010111
1010101010000010000000001010100010001010100010001
1111101011101111111110111011111011101010101111101
1000001010000000100010101000001010000000100010101
1110111011111010111010101111101111101011111110101
1000001010000010000000001000001010001000000010001
1010111010101010101110111111101010111111101111101
1010001010101010100010001000101010101000100010001
1110111010111010111110111010101010101110101110111
1010001000100010101000001010000010001000100010001
1011101011101110101110101011111111101110101110111
1000000010000010100000101010000010001010000010001
1111101011101011101111111010101010111010101011101
1000001010001010000000001000101000001000101010001
1011111111111111111011111111111111111111111010101
1000001000000010101010100000000000101000000000101
1011111010111010101010111110111111101011111110111
1010001010001010000010100000001000101000000010001
1011101111101010111010111011111011101011111110111
1000001000001010001010101010001000101000000010001
1010111111101110111010101011101110101011111010111
1010001000001000001010000010001000101000100010001
1110111110101011101010101110111011101010111010111
1000001000100010001010100000001000101010100010001
1011111111111111101110111011111110101111111011101
1000101010100000100010100000100010001000000010001
1010101010101011111010101010101010101110101111101
1010001000001010100010101010001000101000100010001
1110111110111010101111111011111111111011101111101
1000001010001000000000101000100000001000100010001
1111101010101011101110101010101111101110111111101
1000001000101000100010000010000010001000000010001
1011111111101111111111111111111111111111111110111
1010101000001010001000001010000010100000101010001
1010101011101011101110111010111010111010101011101
1000101000101000000010100000001010000010000010001
1011101011101110111010101011101010111010111111101
1000001000100000001000001010001000100010000010001
1111111111101111111111111111111111111111111110111
1010101010000000100010101000000000000000000010001
1010101010111111101010101010111010101010101010101
1000100010101000101000000010100010101010101010101
1011101010101110111111101011111111111011111010111
1000001010000000101000101000100010000010000010001
1011111010101011101010101011111010111010101010111
1000001000101000000010001000000010001010101010001
1111111111111111111111111111111111111111111111111
