1111111111111111111111111111111111111111111111111
1000100010000000000000001000000000100000000000001
1010101010101110111111101111111110101110111111101
1010101000100010100000100000000010001010000010001
1010101111111010101110111111111010111011111010111
1010101000000010100010000000001010100000001010001
1110101111111110111110111111101010111110101011101
1000100010000010000010000010001010100010100010001
1011111010111011111011111010111010101011111110111
1000100010001010001010000010001010001000000010001
1110101111101010111011101111101011111111111011111
1000100000001010100010000010001000000000001000001
1011111111101010101110111110111111101110101111101
1010100000101000101000001000100010101000101000001
1010101110111011101111101011101010101111101011101
1010001010100010001000101010001010100010001000101
1010111010101110111010111011111010111011111110101
1010000010101000100010001000001010000010000000101
1011111010111011101111101010111010111110111111101
1000100010001000101000001010100010001000101000001
1110111111101011101011111110101011101011101011111
1000001000101000001000000000101000001000001000101
1011101010101111111010111111101111111011101110101
1010001010000000001010100000100010000010001000101
1010111111111111101010101011111010111110111011101
1010001000000000101010001010000010100010100000101
1111101010111010101011111010111110111010111110101
1000001010001010101010001010000010000010001000001
1011111011101010101010111011111011111111101011111
1010001000101010100010000010000010000000001010001
1010101110111010111110111110111110111111101011101
1010101000100010000010100010100010100010001000001
1010111011101111111010101010101011101010111111111
1010000010100000100010101010001000101010000000001
1011101110111110101111101011111110101011111111101
1010001000000010100010001000001000001000001000001
1010111011101010111010111111101011111011101011111
1010101000101010001000100000101000001000101000101
1010101010111010111011101010101010111010101110101
1010101010100010001000101010001010100010100000101
1010101011101011101011101011111110101110111111101
1000101000101000101010001010000000100010000000001
1011101110101111101110111010111111111011111111101
1000100010100010001000101000101000001010000010001
1110111010111110111011101111101010101010111010111
1010100010000010101000100000100010100010101000101
1010101111101010101110101110111110111110101111101
1000100000001000100000001000000010000010000000001
1111111111111111111111111111111111111111111111111
