1111111111111111111111111111111111111111111111111
1000001000000010000000001000001000000010000000001
1110101011111011111111101011101110111011111011101
1000101010001000001000001000100000001000100000101
1011101010111011101011101110111111111110101110111
1010101010000000100010100000000010100010100010001
1010101011101111111110111111111010101010111011101
1000100010000010000010001010001000101010100010001
1110111111111110101011101010101111101010101110101
1000100000000000101000001010100010001000101000101
1011101111111111101111111010111010111011101011111
1010001000000010100000100000101010100000101000001
1010111011111010101110101111101010111110101111101
1010100010000010001000101000101000100000101000101
1010101111101111111011101110101111101111111010101
1000100010001000000000101000100000100010000010001
1111101010111010111111101011101110111010111111111
1000101010100010100000001000100010001000001000101
1110101010101110111110111010111010111111101010101
1000101010101000100010000010001010000000100010001
1010111010111011101011111111101111111011111111101
1010000010001010001010001000000000100010000000101
1011111111101011101110101011111110111010111110101
1000100000001000001000101010000010100010100010001
1110101111111110111011101010111010101110101111101
1000101000001010101000100010001010101000100000001
1111101011101010101011111111101110101111111011111
1000001010000010001010000000100000101000001000101
1011111010111111111010101111111011101011111110101
1010000010100000001000100010001010000010000010101
1010111010101110111111111010111010111110111010101
1000100010101000100010001010000000100010001010101
1011101110101011101110101011111111111011111010101
1010001000101000100000101000000010000010001000001
1010111111101110111111101111111010101110101111111
1010100000001000100000000000101000100010100000001
1010101111111011101111101010101111111010111011111
1010100000001000001000101010100000101000100010001
1010111111101111111010111010111110101111101110101
1010000000001010000010100010000000100010001010101
1011111111111010111110101111101111101110101010101
1010100000000010001000101000100000001000101000101
1010101111111011101011101010111111101011101111101
1010101000000010001000001010000000101000100000101
1010101011111110111111111011111010101110101110101
1010001000001010000000100000001010101000101000101
1011111111101011111010101111111010111011101011101
1000000000001000000010001000000010000010001000001
1111111111111111111111111111111111111111111111111
