1111111111111111111111111111111111111111111111111
1000000010001000000000100010000000000010001000001
1111111010101011101110101011101111111010101111101
1000000010101000100010101010001000000010100010001
1010111111101111111010111010111011111010111010111
1010000010001000001010100000100010001000101000101
1011111010111010101010101111101110101111101011101
1010001000100010100010100010001000100000001010101
1010101111101110111110111011111011111111111010101
1000100000101010100010100000001000000000101010001
1011111110101010101010101110111011111110101010111
1010000010001010001010001000001010000010001010001
1010111011111011111011111111101010111111111011101
1010101000001010000010000000100010100000000000101
1010101011101010111110111111111110101111111111101
1010001010001010100010100000001000100000000000101
1011111011111010101010101110111011111111111110101
1000000010000010101010100010001000000000100000001
1111111110111010101010111011101111101110101111111
1000000000101010101010001000101000100010000010001
1011111111101010101011101110111010111111111010101
1010100000001010101010001000001010001000000010101
1010101011111010101011101011101011101011111111101
1010001010000010001000100010001000101000100000001
1011101110101111111110111010111110101110101111111
1000101000100010000010100010000000100010100000001
1110101011111110111010101111111111111010111111101
1010001000000000100010100000000010001010000000001
1011111011111111101110111111111010101011111111101
1000001010001000101000100010001010101010100010101
1110101010101010101011101011101010111010101010101
1010100010100010001010001000001000100010101000101
1010111010111011111010101111111011101110101111101
1010001010100010100010101000001010100000100000001
1010101110101110101111101011101010101111111111101
1010100010100000100000001000101000101000100000101
1010111010111111111111111110111110101010101111101
1010101010001000000000100010000000101010100000101
1010101011101011111110101011111110101010101110101
1010100010000000000010001000100000100010001010101
1010101111111111111111111110101111111111111010101
1010100000001000100000000000100010001000000010001
1011111111101110101111111011111011101111101011111
1000000000101000101000001000001000000000101000001
1011111011101011101011101111111011111110101111101
1000101010001000100010001000001010001000101010001
1110101010111110111110111010101010111011101010111
1000001000000000000010000010100010000000001000001
1111111111111111111111111111111111111111111111111
