1111111111111111111111111111111111111111111111111
1000000000000000000000000000000000000000000000001
1011101111101111101010101111101110101110111010111
1000100010000000101010101000000010100010001010001
1011101010111010111111101010111110111110111110101
1010001010001010100000001010100000000010000010101
1011111010101110101010101010111111111111111010101
1000001010101000101010101010000000001000000010101
1111101011111111111011101011101111111111111110101
1000001010000000000010001010001000000000000000101
1010101111101110101010111010111111111010111010111
1010101000001000101010001010100000000010001010001
1110111010101111101111111110111011101110111111111
1000100010101000000000000010100010001000000000001
1011101110101010101111111111111111111011101110101
1000100010101010100000001000000000000000101000101
1011101011111011111010111011101011111111111110111
1010001000001000100010001000101000100000000000001
1010101011111010111010101010101011101010111010101
1010101010000010100010101010101000101010001010101
1011101111111110111111101110111110111010101010101
1010001000000000000000101000100000001010101010101
1011101010111110111011101111101011101110111110101
1000101010001000001000101000001000100010000010101
1011101110101010101011111111111110111111111011101
1000100010101010101000000000001000001000000010001
1110111110101111111110111111101110111111111111101
1000000010101000000000000000101000000000000000101
1011111011111011111011101111101011101011101010101
1000001000100000001000101000001000101000101010101
1011101111111111111011111010101011111010101111111
1000100000000000100000001010101000100010100000001
1011111011101111111011111011101011101011101110111
1000001000100010000000001000101010001000101000001
1110111110111010101111101110111011101110101011101
1000001000100010101000001000001000100010101000101
1110111011101111111111111010111111101110111011111
1000100010000000000000100010000010001000001000001
1011101110111111101110101110101111111110101010111
1010000010000010000010101000100000001000101010001
1110111111111110111110111011101110111110101111111
1000100000000000100000100000101000100000100000001
1011101010111111111010111010101111111010101010101
1000101010100000000010100010101000000010101010101
1010101111101011101010101010111111111011111010101
1010100010001010001010101010000000001000001010101
1011101010101110101011111011111110111011111110101
1010001010100010101000001000100000001010000000101
1111111111111111111111111111111111111111111111111
