1111111111111111111111111111111111111111111111111
1010001000101000001000000010000000001000000010101
1011101110101110111111111010101111111011111110101
1000001010100000001010000000101000000000000000101
1111101010111110101011101111101110111111111110101
1000001010101000100010000000100000000000000010101
1110101010101111101110101111111110101110101111101
1010101000101000100010100000000010100010101000101
1010101010101110101010111111111010101111111110101
1000101010000010001000001000100010101000100000001
1110111111101011111110111011111111111110111110111
1010101000101010100000101010000000000000001000101
1010101110111010111011101011111011101111101011101
1000101000000000000010100000001010100010000010001
1110101011101010101010101111101010111111111010111
1010001010001010101000000010100010100000001010001
1010101110101011111110101110111110101111101011101
1000100000101010000010101000001010001000101000101
1110111111111111111011101110111010111011111111101
1000001000001010000010000010001000000000100010101
1111111111101011111011101110111011101111111010101
1000000010000000100000100000101000100010001010001
1111111011101110111011111011101011111110111010101
1000000000001010101000100000100000001010001000101
1111101110101011101010101111111011111010111011111
1000000010100010100010101010001000000000001010001
1011101111111010111110101011101110111110101011101
1000100010100010101000101000000010001010101010001
1111111110111010101110101110111110111010111010111
1000000000000000001000001010001010100010100000001
1011111111101110111111101010111010111011111111101
1010100010001010000000000000101010000010101010001
1110111011111011111111111011101010111110101011101
1010001000001010101010000000001000101000101000001
1011101011111010101011111011111010101110101110111
1010100000101000000010100010101010000010000000001
1010111011101111101110111010101111101010111111111
1000101000000000000000000010000000101000000000001
1011101111111110101111101011101111101111111010101
1010001000101000101000001000001010000000101010101
1011101011101111111111111111101010111010101111111
1010101010001000100000101000000010101010101000001
1010101011101011101111101110111010101111101011111
1010001010101000001000101010100000001000100010101
1011101010101111101110101011101010111110101010101
1000001000000000000000000000001010001000101010001
1111101010111010111110111111101010111110101110101
1000000010001010100000100000001010000000000000101
1111111111111111111111111111111111111111111111111
