1111111111111111111111111111111111111111111111111
1000001000000000001000000000001000100000100000001
1011101110111111101111111010101010101010111111101
1010100010001000001000001010101010001010000000101
1010111010101011111011101010101111111011111110101
1010001010101010000010001010100010001000100000101
1011101011101011111010111110111010101110101111101
1010001000101000000010000010001000100000100000001
1010111110101111111111111010101111111111111111101
1010000000001010000010000010101000100000100000001
1010111111101010111010111110101010101110111111101
1010100010001010001000100010100010100010000000101
1011101011111011101111111010111110111011111110101
1000001000001010101000001010000010000000000010101
1111111111101010101011101010111111101111111110101
1000000000100010101000100010100000101000000000101
1110111111111110101010111110101110111011111111101
1000100000000000101010000000101010100010000000001
1011101111101110101111111110101010101111111011111
1000000000100010100000100010101010101000001000101
1011111110111010111110101011101010101011101110101
1000100010100010100010001000101000101010101000001
1110101011101110101011111110101011101010101111101
1010101000001000001000001010001010000010100000101
1010101111111111111111101011111011101110111110101
1010100000000000001000100010001000100000001000101
1010111111111111101010111010101110111011111011111
1000100000000000101010001010100010001010001010001
1011111011101110101011111010111111101110101010101
1010001010001000101000000000100000100000101010101
1010101110111110101111111111101011111111101010101
1000100010000010100000000010001000000000101000101
1111111011101011111111111010111111101111101111101
1000001000101000000010000010000000100000100000101
1011101110101111101110111111111110111110111110101
1010001010100000100010000000001000100010000010101
1110101010111111111011111011111011101010111010101
1000100010100000000010000010000010101000100010001
1011111010101111111010101110111110101011111111101
1000001010101000000010101000100000101010000000101
1011101010101110111110101011101110101110111011101
1010101010100010101000101010001000100010100010001
1010101110111010101011111011101011111010101110111
1010100010000010101010001000101000100010101000101
1010111011111110101010101110101110101010101011101
1010001010000010101000100010100010101010100010001
1010101010101110101111111010111110101110111110101
1000101000100000000000001000000000100000000000101
1111111111111111111111111111111111111111111111111
