1111111111111111111111111111111111111111111111111
1000001000000000100000100000001000000000001000001
1110101011111110101010101111101010111111101111101
1000101000100000101010101000101010000000100000101
1011101010101111111010101010101111101110111110101
1010001010101000000010001010100000101010100000101
1010111110101011111111111011111110101010101111101
1010000010100010000000001000100000100010100010001
1011111010111111111110101110101111111110111010101
1000001000100000100010100000100010000000101000101
1011101111101110101010111011111010101111101111101
1000100010001010001010100010000010101000000000101
1111111010111011111010101110111111101011111110101
1000000010100000100010101010100000001010100000101
1011111010101110101110101010111110111010101110101
1010000010001010101000100010100010101000100010101
1011111111111010101011111010101010101110111011101
1000000000000000101000001010101000100000001010001
1011111111111111101011101110101111111011111010111
1000100010000000101010100000100000001010000010101
1011101010111110101010111111101111101110111010101
1010001010100000001010000000000010001000100010101
1110111010111111111011111111101110111011101110101
1000100010000000001000000000101000100000100010101
1011101111111111101111111110111011101110111110101
1000100000000000100010001000000010100010001000101
1110111111111110111010101111111110101111101011101
1000100000100010001000100010000010001000101000001
1011111010111011101111111010101011111010101111101
1000100010000000101000000010101000000010000000101
1010101111111110101011111110101111111111111110101
1010100010000010100010000010101000100010000000101
1010111010111011111110111010101010101010111111101
1010100010001000000000001000100010001010000010001
1110101011101111111111111111111111111010111110111
1000101010101000100000000000100000000010100000101
1011101010101010101111111110101111111110101111101
1000101000101010100000001010101010000000101000001
1111101111101110111111101010101010111111101010111
1000000000100010000010001010101010100000001010001
1011111110111010111010111010101010101111111011101
1000001010001010001010100000001000101000001000101
1111101011101010111010111111111011101111101110101
1000001000100010100010100000100000100000100000101
1011111110111110101010101110111011111110111111101
1000100000000010101010001010001010000010000010001
1110101111111011101011111011101110111011111010101
1000001000000000001000000000100000001000000000101
1111111111111111111111111111111111111111111111111
