1111111111111111111111111111111111111111111111111
1000100010001010000000100010000000100010100010101
1110101110111010101010111010111110101110111010101
1000000010001010101010100010001010101000000010101
1011101010111010111110111010111010101010101110101
1000101010000000000010101000101010000010100000101
1110101111101011101110101010101010101111101110101
1000100000001010000010000010000010100000100010001
1110111111111111111111111111111111111111111111111
1000001000100010000000100000100000100000001000101
1011111110101110111111101011101110101111111010101
1010001000000010000010101000001000101000100010001
1010111011111010111010111110101111101011101011101
1010000000100010101000100000101000101010001000101
1011101111101110101110111011101010101010101111101
1000001000000000001000101000100010000000101010101
1111111111111111111011101010111110101111101010101
1000000010100000001010100010100000100000101000001
1011111110111011101010111111111111101111111111111
1000000010100010000000100000000000000010001000101
1110101110111011101011101011101011101010101010101
1000100010000010001000101000101000101000100010001
1110111010111010111110101111111111111111111111111
1000100000100010001000100000000000000000000000001
1110111110111111111011111011111111111111111111111
1000000010101000000000100000100010001000101000101
1111101110101010101011111010101010101011101010101
1000000010100010101000100010101000100000000010001
1111111111111111111110111011111111111111111110111
1010101000001010001000100010100010100000001000001
1010101010111010101010101110101110111011111110101
1000100010000000100010100000100000100010001000101
1011111111111110111111101010111010111010111011101
1000101000001000100010101010100010100010001000101
1011101011101110101110111110111110111011101011101
1000000000100000100010101010000000100000001000101
1011111111101111111010101010111010111111101011101
1000100000000000100000100000100010000000000000101
1011111011111111101111111110111011101110101110101
1000101010000010100000100000100000100010101000101
1010101010111010111011111011111111111110111111101
1010101010001010000000100000100010000000100000101
1110101011101010111110111011101010111110111011101
1010101000001000101000101000101010001000001000101
1010101111111110101110101010111010111111101010101
1000101000000010101000100010101000101000100010101
1011101010111010101110101110101010101110101111101
1000100010100000100000000010100010000000100000101
1111111111111111111111111111111111111111111111111
