1111111111111111111111111111111111111111111111111
1000000000001010000000000000001000000010001000001
1011111111101010111111101111101010111110101010111
1010000000101000100000100010001010000000100010001
1010111111101010111110111011111011111111111111101
1010000000001010000010000000000010000010000000101
1011111111101011111011111111111110101110101110101
1000001010001010001010000010100010100010100010001
1111101010111010101010111010101010101010111111101
1000100010001010100010001000101000101010000010001
1011101011101010111111101110101111101011111010111
1000001010101010001000100010100010001000000010101
1111111010101111101110111010111011111111111110101
1000001000100000100010000010001000000010000010101
1011101111101010111010111111101111111110111010101
1000100010001010000010100000101000100000100010001
1111111010111111111011101110101010101011111111111
1010000010000010001000001000101010001000000010001
1010111011111011101111111110101111111111111010101
1000101000101000100000000000100000000000000010101
1011101110101110101111101111111111111111101110101
1010000010001000100000101000001000000000001000101
1011111010111011111110101010111011111111111111101
1000000010100010000010100010001000001000000000001
1111111010101110111010111111101010101011111111101
1000100010100000101010100000001010101000100000001
1010101110111111101011101011111110101110111011111
1010001010000000000010001010000010100010001010001
1011111011111111111010111110111010111011101011101
1010001000001000000010000000100010001000101010001
1010101111101011111111111111101111101110101010111
1010100010001010001000100000100000101000101010001
1010111010111010101110101110111110101011101010101
1010100010001010100000100010000010001010001010101
1010101110111010111110111011101011111010111011101
1000100000100010001010001000101010001000001000001
1111111111101111101011101110111010101111101110111
1000100000100010101010001000100010101000100010001
1010101111111010101010111111101110101011111010111
1010001000000010001010001000001000101000000010001
1011111011111111101010101011111011101111111111101
1000100000001000101000100000000010001000000010001
1110101111101010101111111111111011111111111011101
1010101000101010100010000000000010000010001010001
1010111010101011101010111111111110111010101010111
1000000010001010001010100010001000101000100010101
1111111111101010111011101010101011101011111110101
1000000000001000001000001000100000001000000000001
1111111111111111111111111111111111111111111111111
