1111111111111111111111111111111111111111111111111
1000000000000000000000000000000000000000000000001
1111111010111011101010101111101010111011101111111
1000000010100010001010101000001010001000100000001
1111111010101111101010101110111011101111111110101
1000000010100000101010101000001000101000000000101
1110111010111010111011101010111011111011111110101
1000100010100010100000101010100000001000001000101
1111101110111111101111111111101010111011111110111
1000000010000010000000001000001010001010000000001
1010111110111010111110111010101011111010101110101
1010100000100010000010001010101000100010100010101
1010111111101010101111111110111011101010101010111
1010100000001010100000001000100000101010101010001
1010101010111010101110111111111011101011111010101
1010101010100010101000100000000000101000100010101
1111101110111011101111111111111010101111101111111
1000000010100000101000000000000010100000100000001
1011101110101011111111101111101010111111101111101
1010001000101010000000000000101010100000000000101
1111101111111010101011101011111111101111111111101
1000000000100010101010001000100000000000000000101
1110101111101110101010111111101011111111101110111
1000101000001000101010000000101000000000101000001
1010111010111010101111111011101111111011101011101
1010001010001010100000001000101000000000101000101
1111111011101111101110111010101010101011111011101
1000000010000010000010001010101010101010000000101
1011111011111111101110101011101110101111111011101
1000001000100000001000101010000010100010000000101
1110111111101011111110111111101010111111101111101
1000001000001000100000100000001010001000000010001
1011111011101110101010111011101110101010111010101
1010000010000010101010100000100010101010100010101
1110111010111011111110111010101011111110111011111
1000100010100000001000100010101000000010100000001
1010101011101110111011111111111011111111111111101
1010101010001000100000100000000000000000000000101
1010101010101010111110101011111011111010101011111
1010101010101010001000101010000000001010101000001
1010111110111110111010101110101011101011111011101
1010100000000010001010101000101010001010000010001
1110101011101111101011101011111011101110101110101
1000101000100010001000101000001000100010101000101
1011111110101010111111111010111010101111101111111
1010000000101010000010000010100010100010000000001
1010101111101010101110111011101010101110111010101
1010100010001010100010001010001010100010100010101
1111111111111111111111111111111111111111111111111
