1111111111111111111111111111111111111111111111111
1000001000100010000000000000100010000010001000101
1110101010101011111110111110101010111010111010101
1000101010001010001000000010001010100010000010001
1011111011111010101011111011111010111110111111101
1000001010001000100010001010100010100010100010101
1111101011101011111111101010101110101010101010101
1000101000001010001000001010000000101010001000101
1110101011111010101011101011111110101011111111101
1000100010001010101000101000001000101000001000001
1011111110101011101111101111101011101111101010111
1000000000101010001000101000101010100010101010101
1111101110101010111010101110101010111010101010101
1000100010100010100010000010001000001000101010101
1010111010111110101111111010111111111110101010101
1010001010100000101000100010100000000010101010001
1011101110111011101010101110101111111010101011111
1000100000100010001010001000101010100010100000001
1110111111101011111011111011101010101110111111101
1000100010001000001010000000001000001000100000001
1011101110111011101011111111111111111011111011101
1010000000100010001000100000000000100010000010101
1010101111111110111110101111111010101110111110101
1000101000001000100000101000100010100010100010001
1111101011101011111011101110101110111110101111111
1000101000101010001000000000101010000010001000001
1011101110111010101111111111101010111011101011101
1010000010000010100010001000000010001000001000101
1010111110111110101110101111111110101111111011101
1010100000100000101000100000000010100000100010001
1010111011101110111011111111101010111010101110101
1000001010001000100010100000101010001010001000101
1111101010111111101110101010101011111011111011101
1000101000100000000010001010101010000010001010001
1010101110101111111011111010111010111111101011111
1010001000101000101000000010001010000010001000001
1011111111101010101011111111101011111010111111101
1000000010001010001010000000001010000010000010001
1111111010111011111010111111111010111111101110111
1000000010101000000010000010001010100000100010101
1011111110101111111111111010111010111011111010101
1010001000100000100000001010000010001000001010001
1011101011111010111011101110111111101110111011101
1000100010000010100010001000000000101000100010001
1110101110111110101111101011111111101010101110111
1010001000100010100000101000000010001010100010001
1010111011101010111110111110111010101110101111101
1000100000001010000000000000100000100000100000001
1111111111111111111111111111111111111111111111111
