1111111111111111111111111111111111111111111111111
1000000000000000000000000000000000000000000000001
1111101010101011111011101010101011111111101110101
1000001010101010000010001010101000001000000010101
1110111110111011101010101011101010101110111110101
1000000010001010001010101000101010100010100000101
1011101011111111101110101111111011111011111010101
1010001010000000000010100010000000001010000010101
1010111011101110111111101111101010101111101010101
1010001010001000100000000000101010100000101010101
1110111011111011111110111111101110111010111010101
1000001010000010000000000000100010001010001010101
1110101111111010111010101111101111101111101111111
1000101000000010001010100000100000100010000000001
1110111110101110101011101010101010101011101010101
1000000010100010101000101010101010101010001010101
1110111010111011101011111011101110111010111110101
1000100010100000101000100000100010001010100000101
1011101011101111111011111010101111101011111111101
1010001010000010000000001010100000101010000000001
1111101010101110101111111011111110111011101010101
1000001010101000101000000000000010100000101010101
1110111110101111111010111110111110111011111110101
1000000010100010000010100000001000100000000010101
1111101011111011111010111010101110101110101110101
1000001010000000001010100010100010100010100010101
1011111010111011111010111110111011111111101010101
1000001010100000100010100000001000001000001010101
1110111010111111101011111111111010101010101110111
1000001010000000101000001000000010101010100010001
1111101010101111111011111110101111111011101111101
1000001010101000000000000010101000000010000000101
1110111010111111111011111010111111111011111111101
1000100010100000000010000010001000000000100000001
1010111010101011101111101111101110111110101110111
1010001010101010000000100010000010001000101000001
1010101110111110111110111011101011111011101011101
1010100010100000100000001010001000001010001010001
1110111111101010101011111011111011101110111111101
1000000000101010101000100010000000100010001000001
1010111110101010111011111011111010101111111110101
1010000010101010001000100000100010100000001000101
1011111010101010111110101010101011111110101010101
1000001010101010001000101010101000100000101010101
1010111110101011111111111011111011111010111010101
1010000010101000000000100010000000100010100010101
1011111110111010101011101010101110111011111011101
1000000010001010101010001010101000100010000000101
1111111111111111111111111111111111111111111111111
