1111111111111111111111111111111111111111111111111
1000000010000000001000100010100010001000001010001
1111101111111011111010101010101111101010111010101
1010000010001000100010101010000000001010101000101
1011101110111010101011111011111011111110101011111
1010100010101010101000001000101010001010101000001
1010111010101010101110111110101011101010101110101
1000100000000010001000000000000000000000000000101
1110111110111110111111101111111011111011111011111
1000001010000010100010001010001000001010100010101
1010101010111110101110111011101110111110101110101
1010100010000010100010100000100010001010001000001
1111111010111111101011101111101110111010111010111
1010001000101000001010100010000010100000000010101
1010101110101110111010111010111110111011111110101
1000100000000000001010000000001010100010100000001
1011101110111111111011111011101011111110111011111
1010100010001000100010000000100000101010000000101
1110111111101011101111111011111110101011101111101
1010100000000010000010100000000010100000001000001
1010111111111010101110101111111011111110101011111
1000101010100010101010100010100000100000101000101
1010101010111011101010111010101110101111111011101
1010101010101010000010101010001010000000100000001
1110101010101111111010101110101010101011111010111
1010000000000000101010001000100010101010100010001
1010111010111111101011101110111010111010111010111
1000100010101000101010100000001010001010000010001
1111111110101011101110111011101111111011111011111
1000100010100010100000001010001000000000101000001
1010111010101010101011111111101110111111101110101
1010001010001000101000001010001010100010101000101
1011101010101110101010111011101010111010101011101
1010000010101010001010101010000010001010000000101
1111101111101011101110101010101011111010101110111
1000000000101010001000100010101000000000100010101
1111101011101011111110101111101011111110111011101
1000101000001000000000101000101010000000001000001
1010101111111110101111101011101111101110101110111
1010100000101010100010100000001010001000101000101
1110111110101011111110111110111010111110111110101
1000101000001000101010100000100000100000000010001
1011101011111011101010111011101111101111101011111
1000001000001000100000000000101010101000101000001
1110111110101110101010111010111010101010101111111
1000000000100000001010101010101000000010100000001
1010101110111010111011101111101110111010111011101
1010100010100010001000000010000000100010001000101
1111111111111111111111111111111111111111111111111
