1111111111111111111111111111111111111111111111111
1000000000000000000000000000000000000000000000001
1011111011101010101010111010101111101010101011101
1000100010001010101010100010101000001010101000101
1011101010111011111110111011101011101111111110101
1000101010001000100000001000101010001000000000101
1010101011101010111010101110101010111011101010101
1010101010001010100010100010101010100010001010101
1011101011111110101111101111101111111111101110111
1000101000000010100000101000001000000000000010001
1010101010111111101110111010101110111011111011101
1010101010001000001000001010101000100000100010001
1110101010101111111010101010101011101010101011101
1000101010100000001010101010101010001010101000101
1111101010111011101011111011111111101011101111101
1000001010100000101000001000000000101010000000101
1110111111101010101011101011101011111111111011111
1000000000101010101000101000101010000000000000001
1010101110111010101011111111111111111111101111111
1010100010100010101000000000000000000010000000001
1010111011111010111011101110111010101010111010101
1010100000100010001010001000001010101010100010101
1010101110111111101011111011101111101011101111101
1010101000000000101000100010000000101000100010001
1110101010111110111010111010101110111011101110101
1000101010100000001010100010101000100010000010101
1011111111111011111010101011101010101011111011101
1000000000100010000010101010001010101000100010001
1010101011101010111110101010111111101110111011101
1010101000101010001000101010000000101000001000101
1111111011111011101110101111101010111011101011111
1000000000001010000010101000001010001000101000001
1011101010111011101011101011111010101010111010101
1000101010001010001000101010000010101010100010101
1011101110111011101010111111111110111011101011101
1010001000001000101010000000100000001000101010001
1110111111101010101010111010101011101110101110111
1000000000101010101010001010101000100010100010001
1010101110111110101011111110111111101110111111101
1010100010001000101000000010100000001000000010001
1010101111101010101111101010111111101011111110111
1010101000001010101000001010001000001010000000001
1110111011101011101011111111101110101010111110101
1000001000101010001010000000000010101010100000101
1010101011111010111011111010111010111011101011101
1010101000001010100010000010001010001000101010001
1110111110101011101010111011101010111010111110101
1000000010101000101010100010001010100010001000101
1111111111111111111111111111111111111111111111111
