1111111111111111111111111111111111111111111111111
1000100000001000000010100010000000001000000000001
1010101111101011111010101010111111101111111011101
1010001000101000100010101010000010101000100010001
1011111110101010101110101011111010101010101111111
1000100000101010100000101000000010001010001000001
1110101111101110111111101011111110111011111010101
1000100000100000100010001000001010000010001010101
1011111110111011101010111111101011101110101010111
1000100000100010001000100010000010001000100010001
1010111010101110111110101110111110111011111111101
1010000010101000100010100010000010000010001000101
1111111110101011101110111011111011111110111010101
1000001000101010000000100000001000100010000010001
1011101011101010111111101111111110101011111011111
1010001000100010001000001000001000001000001000001
1010111110111011111011101011101011101111101011111
1010100000100010000010001010100010001000001010001
1010101111101011101110111010111110111111111110101
1010100010001000001000100000001000100000001000101
1010111010111111111011111111101011101111101011101
1010001010100010100010000010001010001000100010001
1011101010101010101110111010111010111011101110111
1000100010101000100010001010101000100010000010001
1110101111101110111011101010101111101110111111101
1010101000100010100010001010001000100010101000101
1010111010111110101110111011101011111010101010101
1010000010000010001000001000001000100010100010001
1011111111111010111111111111101110101010111110111
1000000000100010000000000000101000101010100010001
1011111010101111111111111110101011101110111011101
1000100010001000100000000010101010001000001010101
1110101111111110101011111110101010111011101010101
1000100010000010101010000000100010001000101010101
1111111010111010101110111011101111101110111010101
1000001010001000100010100000100000100010000010101
1010111010101111111010111110111110111011111110101
1010000010100000001000100010000010100010100000001
1010111111111110111111101111101110101110101111111
1010000010000010100000001000001000101000001000001
1011111110111010101111101011111011101110111111101
1010000010001000100000101000101000100010000000001
1010101011111110111110111010101110111011111111111
1010101000001000100010000010000010100010001000001
1010111111101011111011111011111110101110101111101
1010001000100000001000001010001000100000100000001
1011101011111110101111101011101011101110111011111
1000001000000000100000001000001000001000100000001
1111111111111111111111111111111111111111111111111
