11111111111111111111111111111
10001000000000001000001000001
11101011111111101010111010111
10001000000000101010100010001
10101111111010101110101111101
10100000001010100000101000101
10111111111011111110101010101
10001000000010000010101010001
11101011111110101010101111101
10001010001000101000100000101
10101010101011111111111110101
10100010100010000000100010101
10111011111110101011101010111
10100010001000101010001010001
11101110111011101010111010101
10001000100010001010001010101
10111011101110111011101010111
10000000001010100000101010001
10111111101010111111101011101
10100010001000100000001000001
11101110111111101111111111101
10001000000010000000001000001
10111011111011111111101011111
10001000101000100010001000001
11101110101010101010111111101
10001000001010101010100000001
10111011111010101010101110111
10000010000010001000100010001
11111111111111111111111111111
