11111111111111111111111111111
10100010000000100000100010101
10111010101010101110101010101
10000000101010101000101010001
10101111111110101011111010111
10100010100010101000000010001
11111010101110101011111111101
10001010100000101000000010101
11101010111010101110101010101
10000010000010101000101010001
10111111111011111111101111101
10001010100000101000100000001
10111010101010101011101110111
10000010001010000000000010001
11111111111111111111111010111
10000010001000100010100010001
10111010111110101110111011101
10100010001010100010000010001
11101110111010101110101111101
10001010000000000000100010001
10101011111110111111101110111
10100010100010101010000010001
11101110111010101010111010111
10000010000000100000100010001
11111010111110101111101110111
10000000100000100000100010001
10111111111111111111111110101
10000000000000000000000010101
11111111111111111111111111111
