11111111111111111111111111111
10000000001000001010000000001
10111111101110101010111111101
10000000100000100010100000101
11111110111111111110101110101
10000000100000000000101010001
10111011101111111111101011101
10100010001000000010001000001
10111010111011111110111011111
10001010101000100000100000001
10101110101010101111111111101
10100000100010100000001000101
10111111111110111111101011101
10000010000000100000101000001
11111011101110111011101111111
10001000001010001000101000001
10111111111011101110101011101
10000000000010101000101010001
11111110111010101010101010111
10000010100000101010100010001
10111010111110101011111111101
10001000100010101010000010101
10101110101010101010111010101
10100010101010100010101000101
10111010101010111010101111101
10001010101010001010100000101
11101011101011111010101110101
10001000001000000010001000001
11111111111111111111111111111
