11111111111111111111111111111
10000000000000000000000000001
10101011111010101110111010101
10101010000010100010100010101
10101111101010111110101010101
10100000101010100000101010101
11101010111011101011101010111
10001010001010001010001010001
10111110101110111110111111101
10000010101000001000001000001
11111110111010101010111110101
10000000001010101010000010101
10101110111011101011111011101
10100010100000101000100000101
11101111101010111110111110111
10000010001010001000100000001
11111010111010101111111110101
10000010001010100010000000101
11101111101110101011101111101
10000010001000101000100000101
10111110111111111010111010101
10000010000000001010001010101
10111110101010111010101111111
10100000101010100010100000001
10101110101010101110101110101
10100010101010100010101000101
10101010101010111011101110111
10101010101010100010001000001
11111111111111111111111111111
