11111111111111111111111111111
10100000001000000010000000101
10101010101010101010101010101
10001010100010101000101010001
11111111111110111111111111111
10000000000010000000101000101
10111110101010111010101011101
10001010101010100010001000001
10101011101110111111111111101
10100010000010100000101000001
10111011111010101010101010101
10001010000000001010100010101
11101110111011101011101110111
10000010001010001000001000001
11101111101111111111111110111
10001010100000001010001000001
11101010111011101011101011101
10000010100010100010001000101
11101010101010101011101111101
10001010001000101000001010001
11111111111111111111101010101
10001000001010000010001000101
11101110111010111111101110111
10000000000000000010101000001
10101110101010111110101111101
10101000101010100000001000001
11101110111010101010111011101
10001000001010001010001010001
11111111111111111111111111111
