11111111111111111111111111111
10001000000010101000101010001
11101011101110101011101011101
10100000100000100010100010001
10111011111111101110111011101
10001010101010100000001000101
11101010101010101111111011101
10100000101010001010100000101
10101110101010111010101110101
10001010000000100000101000001
11101011111111101010111110111
10001000100000001010101010001
10101011101011111111101010111
10100010001010101000101000001
10111010111110101011101011101
10001000100000000000100010101
11111110111011111111101110111
10001000000010000010100000001
11101011101110111010101111111
10000000100000100000000000001
10111011101110111111101011111
10001010000010101000101000101
10101011101111101011101111101
10101010000010101010100000001
11111010101010101010111110101
10000010101000000000100010101
11101010101010101110101110101
10001010101010100010001000101
11111111111111111111111111111
