11111111111111111111111111111
10000000001000100000001000101
10111011101010111110111110101
10101010101010100010001000101
10101010101110101011101011101
10100000101000101010001000101
11111011111110101011101011101
10101010001000001000001000101
10101010111011101111101110101
10000000000000101000001000101
11101110111111101111111011101
10000010001010001000100000101
11101111111010101110101110101
10001010001000100000001000101
10101010101111111011111111101
10100000101010100000100010101
11111110111010101110111010101
10101000001000001010000000101
10101110111110111010111110101
10100010001000101000100000101
10101011101110101110101010101
10001000001000001000101010101
11111111101111111111111111101
10100000101010101000000000101
10111110101010101010101011101
10100000100000000010101000001
10101011101110101110101011101
10001000001000100010101000101
11111111111111111111111111111
