11111111111111111111111111111
10001000000000001000100000001
11101111101111111110101111111
10000010000000000000000000001
10101011101110111111111111111
10101010100010100000000000001
10111110101111101110111111111
10101010101010101010100010101
10101010101010101010111010101
10000010000010000010101010101
11101111111010111111101010101
10000010001000000010101010101
11111011101011111110101010101
10100000000000001000101010101
10111011111011111011101010101
10000000001000001010101000001
10101010111011101010101010101
10101010001000100000000010101
11101110101011101010101111111
10001000101010101010100000001
11101111111010101110101010101
10001010000000100010101010101
11101011101010101011101110101
10000000101010101010000010101
10101110101010111111101111101
10100010101010000010000000101
10111110101110101111111110101
10000010100010100000000010101
11111111111111111111111111111
