11111111111111111111111111111
10000000000010000000100000001
10101010101011101111111111101
10101010101010100000101000001
11101111111110111011101010101
10101000100010100000100010101
10101010101010111110101111101
10101010101010001000001000001
10101110101110101110111011111
10000000000010100000100000001
11111111111011111111111111101
10100010001010000010000000101
10111011101010111110101111101
10101000000010100000101000001
10101010111010111010101010101
10000010001010000010100010101
11101111111110101110111110101
10000000000000100010100000101
11111111101111111111111111111
10100010000000101010000010101
10101110111110101011111010101
10000000000010100000100000101
10111111101110101010101010101
10000010100010101010001010001
11111010111010101011111011101
10001010000010001010000000101
10111011111011101011111011101
10000010000000101010000000101
11111111111111111111111111111
