11111111111111111111111111111
10000010000000000010000000001
10111011111011101010111111101
10100000001010001010100000001
10111111101110111010101111101
10001010001000101010100010101
11101010111011101011111010101
10101000100010001000001010001
10101011101010101111101011111
10101000101010100000101000001
10111110101010111010101111101
10000010101010001010101000001
11111010101010111010101011101
10000010101010100010100010001
10111010111011101011111110111
10100010000010001010001000101
10111111111110101110101011101
10100000000000101000101010001
10101110111111111011101010101
10100010000010001000100010101
10111011111010101110111110111
10000010100010100000100010001
10111110101010111111101010101
10100000101010001000001010101
10101011101111101011101011101
10101010001000001000101000101
10111010111011111111101110101
10000010000000000000001000001
11111111111111111111111111111
