11111111111111111111111111111
10000000000010000000001000001
10111111101011111011101011111
10100000001000000010001000001
11101111101111111110111011101
10001000101000001000100000101
10111110101011101110111111101
10000010101010100010000010001
10111010101110111011111010111
10001010100010001010001010001
10111010111011101010111011101
10100010001000001010001000101
11101110111111101011101110101
10001000000010001000100000001
10101111101010111110111111111
10101000101010100000100000001
10111010111010101111101111101
10000010001010101000001000001
10111111101010101111101011111
10000010101000100000001000101
11111010101111111111111110101
10001000100000000010000010001
10111110111110111110111011101
10000010000010000010101000101
10101111111011111010101110101
10101000100010001010101000101
10101010101110101010101011101
10100010000000101000001000001
11111111111111111111111111111
