11111111111111111111111111111
10000000100000100000100000001
10111111101111111011101010101
10001000100010000010101010101
11101011101010111010101111101
10000000101000100000101010001
10111011101111111010101011101
10001000000000100010000010001
11111110111110101111111110111
10000000100000100000000010001
11101111111111111111111111111
10100010001000100010101010101
10101110101011101010101010101
10000010100000001000001010101
11101111101011101011111010101
10000000001000101000000010001
11111111101111111111101010101
10101000000000001000001010101
10101011111011101111101110101
10100000100000101010000010101
10111110101011101010111010101
10101010101000101000100010101
10101010111110101010101110101
10000000100000101010100010101
11111011111111101111111010101
10100000100000001000000000101
10101110111110111111101110101
10001000100000001000000010101
11111111111111111111111111111
