11111111111111111111111111111
10000010001000001000001000001
10111010101011101011101011101
10001010101010001000101010101
11111010111010111010101010101
10100000100010000010101000101
10101111101111111111101110101
10001000001000001000100000101
10111010111011101010111111101
10000010100010101010000010001
11111011101110101011101010111
10001010001000100010001010001
10101010111010111110111111101
10100010001010100000000000001
10111111101010101111111111111
10000010001010101000000000101
11111110111110101010111110101
10000000100010001010100010001
10101011101011111110101011101
10101000001000001000101000001
10101011111111101011111111111
10101010000010001010000000001
10101110111010111010101110111
10100000101010000010101000101
10111111101011111110101011101
10001000001000100000101000101
10101111101110101111101110101
10100000000010000000100010001
11111111111111111111111111111
