11111111111111111111111111111
10000000000000100000000010001
10111111111110111111101010101
10100010000010001000101000101
10101010111011101010101111101
10001010101000001010001000001
11101010101111111110111011111
10001010100000100010001000101
11111010101010101011101110101
10001010101010101000100010001
10101011111011101110101111101
10100010001000001000101000001
10111110101110111011111011111
10000000100010100000000000001
11111110101110111111111111101
10001000100010100000100010001
11101011111010101110111010111
10001010001000100010100010001
10111010111011101110101111101
10000010001000001000100010101
10111111101111111010111010101
10100000001000000010001000001
10101111111011111111111110111
10101000000010001000000010101
10101010111110101111111010101
10101010101000101000001010001
10101010101011101011101010111
10100010000010000010000010001
11111111111111111111111111111
