11111111111111111111111111111
10000010000010100000000000001
10111110111010101111111111101
10001000100000101000000000101
11101011111111101011111110101
10001000100010001000001010101
10101110101010111111101010101
10101010001000000000100010101
10101011101111111011111010101
10101000001000001000001010101
10111011111011101111101010101
10100010001000100000100010101
10101110101110111011111110111
10101000100010001000000000001
10101011111011111110111011101
10001010001000000010100000101
10111010101111111010101110101
10100010100000100010101010101
10101110111110111011101010101
10101010100010001000001010101
11101010101111101111111010111
10001000100000101000000010001
10111111111010101011111111101
10001000100010001010000000101
11101010101011111010111110101
10001010101010000010000010101
10111010111010111011111010101
10000010000010001000000010001
11111111111111111111111111111
