11111111111111111111111111111
10000000100010001010000010101
11111010101011101011101110101
10001010101000000000001000101
10111011111110111111101011101
10100000100000000010100000001
10111011111110111110111111101
10100000100000000000101010101
10101111101110111010101010111
10100000101010001010101000001
10101111111010111011101110111
10001010001010001010000010101
11101010111010111111101110101
10000000000000000000000010001
11101011111110101111101110111
10001000000010100010000000001
10111010101010101111111011111
10100010101010100010001000001
10111010101110111110111110101
10100010100010000000000010101
10111011101110111110101110111
10001010101010001000100010001
11111010111010101111111011111
10000000001000101010001010001
11101011111011101010111010101
10001000100010000000101000101
11101011111011101010101011111
10001000001000101010100000001
11111111111111111111111111111
