11111111111111111111111111111
10000000000000000000000000001
10111110101011101111101111101
10100000101010001000000010001
11111110101010111010111011101
10000000101010100010001010001
10111110101011101111101110111
10001000101010001000001000001
11101111101010101111111010101
10001000001010100000100010101
10101011111011101110101010111
10101000001010000010101010001
11101110101011101011101010101
10001000101010001010001010101
10111011101111111010101010101
10100010001000000010101010101
11101110101010101110101110111
10000010101010100010100010001
10111110111011111011111110101
10100000100000100000100000101
10101011101011101111101111101
10101000101000100010000010001
11101010101110111110111010111
10001010100010100000001010001
10101011101110111010111111101
10101000101000001010000000101
11101110111011101010101011101
10001000001000101010101010001
11111111111111111111111111111
