11111111111111111111111111111
10100010100000101000000010001
10111010101110101011101011101
10100000101000001010101010001
10111010101110101010101110111
10000010001000100000100000001
10101111111111111111111111111
10100010001000000000000010001
10101111101010111011101011101
10100010001010100010001000001
10111011101111101110111111101
10100010001000000010001010001
10101011101011101011101011101
10101010001010001010001000001
10101110101111101010111111111
10100010100000001010100000001
10101111101011111110101010101
10100000001000000010001010101
10101111101011111110101110101
10100010001010000010101000101
10111010111010101010101011111
10100010001000101010101000001
10101111111111111111111110111
10100010000000101000000000001
10111010111011101010111011101
10101010101000000010001000101
10101010101011101110111010101
10100010001000100010001010101
11111111111111111111111111111
