11111111111111111111111111111
10000000100010100000000000001
10111110101010101110111111101
10001010101000101000100000001
11101010101011101011111011111
10001010101010001000001000101
10111010101010111111101110101
10100010101010100010001000101
10101110101110101010111011101
10100000100010101010100000001
10101111111010111010111111111
10100010001010100010100010001
10111010101010101010101010101
10001010100010001010001000101
11111010111011111011111111101
10100010001010000010001010001
10101110101110111110101010101
10101010100000000000100010101
10101010111111111111111010101
10001000100010000000001010101
10111110101010111111101110101
10000010001010000000100000101
11111011111110111110111111101
10001000100010100010000010001
11101110101011101011101010111
10001000101000101000101010001
10111011101110101110111011101
10000000001000001000000010001
11111111111111111111111111111
