11111111111111111111111111111
10101010001000100000100010001
10101010111110111011111011101
10000000000000000000001000101
11101111101111111111101011101
10101010001000000000000000001
10101010101110111011111110111
10001000101010101010100000001
11111111101010101010111010101
10100010101010101010000010101
10101110111011101110101011101
10000000000000000000101010001
10111110101110101110111011101
10001010101000101010100010001
10111010111111111011111011101
10001000100010000010100010001
10111111111011101110101010111
10100000000010000000101010001
10101111111011101110111010111
10101000000000001000000010001
11111110111010111110111010111
10100000100010100000100010001
10111111101011111010111011111
10101000001010000010001000001
10101010111110101111101110101
10000010001010100000100010101
10111010101011101111101110111
10001010101000000010001000001
11111111111111111111111111111
