11111111111111111111111111111
10000010000000000000100000001
10111010111110111110111011101
10001000001010100000001010101
11111111101010111111101010101
10000000100010000000101010001
10111110111011111110101010111
10100010001000000010100010101
10101111101111111010111110101
10100000100010000010100010001
10111110111011111110101011101
10100010000010000000101010001
10101111111110111111101110111
10101000000000100000100010001
10101011111010111010111011101
10100010001010100010000010001
10111110101110101110111110111
10000010100000100010100010001
11111010111111101011101011101
10001000101000001000001000101
10101111101011111111111110101
10100010001010001000001010001
10111110101010101010101011111
10100000101010101010100000101
10101111101010101110111110101
10100010001000100010100010001
10111010111111111010101111101
10000010000000000000100000001
11111111111111111111111111111
