11111111111111111111111111111
10000000000000000000000000001
11111010111111101011111110111
10000010000010001010000000001
10101010101011101011111111101
10101010101000101000100000001
10111010111010111111111011101
10100010001010001000000000101
10111111111111111011111111101
10100000000000000000000000101
10111010111010101011101011101
10100010100010101010001000101
11111110111111111110101110101
10000000000000100000100010101
10101011101111101010101110101
10101010000000101010100010101
10111011111011101010111011101
10100000100010001010001000101
11111011111011101011101011111
10000000100000101000101000001
10111011111011101011111010111
10100000001010001000100010001
10101110101010111111101011111
10100010101010001000001000001
11101111101011101011111011101
10000000101000101010000000101
10111111101110111010111011101
10000010001000001010100010001
11111111111111111111111111111
