11111111111111111111111111111
10000000100000000010001000101
10111111101111111010101010101
10100000000000001010101010101
10101111111111101011101010101
10001000100000101010001010001
10111010111010101010111011101
10000010001010101000001000101
11111111101110101111101110101
10100000100000101000001000101
10101111111110101111111010101
10100000001010101000001010101
10111111101010101011111010101
10100000001010101000100010101
10101011111010101110101111101
10001000100010101000001000001
11111110101010101011111011111
10001000101010101010000010001
10101011101010101110111111101
10100000101000100000100000001
10111010101111111110101111111
10100010101000100000100000101
10101110101110101111111110101
10100010100000101000000010001
11111010101111101110111010111
10000010100010100010101010001
10111110111010101010101011101
10000010000000101000100000001
11111111111111111111111111111
