11111111111111111111111111111
10001000100000000010000000001
10101010101111111010111111101
10100010100000001000001000001
10111110111111111111111010111
10100010100000000000001010001
10101010101111111110101011111
10101010001000000010100000001
10101011111011111011111111101
10001000000010001010000000101
11111111111110101010101111101
10000000000000101000101000001
10111111111111101111101011111
10000010001000100000001000101
11111010101010111110111010101
10001010100010000010100010101
11101010111111111011101110101
10000010001000100010001000101
10111011101010111010111011101
10100010000010001000001010001
10101110111111101110111010111
10100010000010000010001010001
11111011111011111011101011101
10000000101000001000101000001
10111110101110111011101111111
10001000100010100010001000001
11101011111011101110111011101
10001000001000001000000010001
11111111111111111111111111111
