11111111111111111111111111111
10000010000000000010000010001
10111111101111111110111010101
10000010101010101010001000101
11101110101010101010111111111
10100010000000100010000010001
10101010111011111011101011101
10001010101010000010001010101
11111010101010101111101110101
10000010100000100010101000001
11111010101111111110101010111
10000010100000100010000010001
11101110111010111010111111111
10001010100010000000001000001
10101011101111111110111010111
10101010000000000010000010001
10111011111111111011111011101
10000000000000000010000010001
11111111111011111111111111111
10101010000000100010001000101
10101010111010101110111010101
10001010100010000000000010101
10111010101011101111101111101
10001000101010000010100000001
11101110111111101010101010101
10000000000010001010001010101
10101110101011111011101111101
10101000101010000010000000101
11111111111111111111111111111
