11111111111111111111111111111
10000000001000100000000000001
11111110101010101011111111111
10000010100010101000000010001
10111011101111101111111010101
10001000001000101000001010101
10101111111010111011101010101
10101000100010000010001000101
11101010101111111110111111101
10000010100000000010100000001
10111110111110101010101111111
10100010001000101010100000001
10111011101111101010111011101
10100000100010001010000010001
10101011111010111111111110111
10001010000010100000000000001
11111110111110101111111111111
10001000001000101000001000001
10101011101011111011101111101
10101000100010100010100000001
10101011111110101010101011111
10101010000010101010001000001
10101010101010101011111111101
10101000101010001000000000101
10101111101011111111101110101
10100000101000000010001000101
10111011101110111110111011101
10001000001000000000100010001
11111111111111111111111111111
