11111111111111111111111111111
10000010001010001000001000001
10101110111010111010111110111
10100000001010000010001000001
10111011101010111110111011111
10100010001010001000001010001
10111011101010111011101010101
10100010000000101000101000101
10111110111110101110101110111
10100000000010001000100000101
11111111111011111111111110101
10001000000000001000001000001
10111110111110111011111110101
10001010001000001000001000101
10101010101110101110111111101
10101000101000100010101010001
11101111101111111010101010101
10001010000000001000001000101
11101010111111101111101111101
10001010000010001000101000101
10101011101111101010101110101
10101000000010001010001000001
10111010101011101110111111101
10001010101010001000001000001
11101111101111111111101011111
10001000100010001000001010001
10111110101010101010111010111
10000000001000101010001000001
11111111111111111111111111111
