11111111111111111111111111111
10000000000000100000100000001
11111011111110111010101111101
10000010000010100010001010001
10111111111010101111111010111
10000010001010101000000010101
10111010101010101111111010101
10001000101010100010000010101
11111111101010101010111010101
10000010001000101010100010101
10111010111011111010111110101
10100000100010000010001000101
10111111101111101110101011101
10001000101000001000101010001
11101110101011111011101010101
10001000101010100010001000101
10111011101010101110111111101
10101000001010000010000000101
10101011111011101111101111101
10100010001000101000101000001
10111010101110111010101011111
10001000100010100010001010001
11101111111010101111111010101
10101000101000100000001010101
10101011101111101111101010111
10100010100000001000100010001
10111110101111111010111111101
10000000000000000010000000001
11111111111111111111111111111
