11111111111111111111111111111
10000000001010001000000010001
10101111101010111010111010101
10101000001000100010101000101
11101011111110101110101011101
10001010000010101000101010001
10111011101010101110101010111
10001000101010001000100010101
10101110101011111011111110101
10100010001000000010000010101
10111011111111111110111010101
10100010000010000000001010101
10101110101011111111111010101
10100010101000001000000010001
10111010101111101011111110101
10001000100000101010000000101
11101111111111101010111111101
10000000100000001000100010001
11111111101110111111101110111
10000000001010000000100010101
10101111111011111010101010101
10100010001010100010101000101
10111010101010111110101111101
10101000100010001000101000001
10101111111111101011101011111
10001010001000001000101000001
10111010101011111110101111101
10000000101000000000100000001
11111111111111111111111111111
