11111111111111111111111111111
10001000000010000010000000001
11101011111010111010111111101
10001000100010001010001000101
10111110101110101010101011101
10100000100010101000101000101
10101111101011101111101010101
10100010001000001000001010001
10101011111111111011111011101
10101000100000001010001000101
10101110101111111010101110101
10100010100000001010100000101
10111010101111101011111111101
10000010101010001010001000101
10111110101010111010101110101
10100000101010100010100010101
10101111101010101010111010101
10100010000010101000101010101
11111011111110111111101010101
10000000000010000000100000101
10111111111011101110101111101
10100000001000100010001000001
11101111101110111011111011111
10001000101000100010001010001
10111010101011101110101010101
10101010001000101000100010101
10101011111110101011111111101
10001000000000101000000000001
11111111111111111111111111111
