11111111111111111111111111111
10000000001000100000100000101
10111110111010101110101110101
10000010100010001010001010101
10111011101111111011111010101
10001010001000000000000010101
11111010111011101111111110101
10000010001000101010000000101
10111011101110111010111111101
10001010100010001000100000101
10101010111011101111111010101
10101000001000100000001010101
10101111111110101111101010101
10100000001000100010101010101
11111011101011111010101010101
10001010001010000010100010001
10101110111010111110111111101
10101000100010101000000000101
10101010101110101011111010101
10100010100000100000100010101
10111110111111111111101110101
10001000101000000000001000101
11101011101011101111101111101
10001000001010100010001000001
10111111111010111010111011111
10100010000010001010100010001
10101010111111101011101111101
10001000000000001000000000001
11111111111111111111111111111
