11111111111111111111111111111
10000000000010000000000010001
10111110111110111111101011101
10001010001010000010001000001
10111010101010111011101110111
10000010100000100010001000001
11111011111111111010111010111
10100000001010000010001010001
10111010101010111111111010111
10000010100010001010101010001
10101111111010111010101110111
10100000100010000000001000101
11111111111010111111111110101
10001000100010100000001000001
10101011111010101110101010101
10101000000010100010101010101
10101110101110101110101110111
10100000100010000010101000101
11111111111111101111111010101
10100000000010001000101010001
10101111101110101110101111101
10100010000000101000101000001
10101110101010101011101011111
10100010101010101000001010001
10101110111111101011111011101
10100010101000101010001000001
10101110101010101011101011111
10000010000010100000001000001
11111111111111111111111111111
