11111111111111111111111111111
10100000000000000010000000001
10101010111111111010111111101
10001010100010000000100010001
10111010101011111111101010111
10001010101000000010001010001
11111011101111111010111011101
10000010001000001010001000001
10111110111110111011101111111
10001000100000100010000010001
11101011111011101111111010101
10001000001000100000001000101
10111111101110111111101111111
10001000001000001000100000001
10101011111011101010111111101
10101010000000101010000000101
10101010111110111011111110101
10101010100000100010000010101
10101010101110101110111010101
10100010101000101000101000001
10111110101111101110101111111
10000010100000100010001000001
11111011111110111011101111101
10001000000000001010000000101
10101110111111111011111111101
10100010100000000010000000101
10101110101111111110111110101
10100000100000000000000010001
11111111111111111111111111111
