11111111111111111111111111111
10000010100000100000101000001
10111110111011111110101110111
10100010001010001010000000101
10111011101011101011111011101
10000000000000100010000000101
11101011111011111011111110101
10001010100000101010101000001
10111110111010101010101111101
10100010101010000000001000101
11101110101111101010111011101
10000000000010101010100010001
11101010101110111110101011101
10001010100000101010101010001
11101110101110101010111011101
10100010101000000010101010101
10111010101011111010101010101
10000010101010100000000000001
10101111111110111111101111101
10101000000010000010001010001
11101111101110111011111010101
10101000100000001000000000101
10111110111111111010111010111
10001010100000000010100010001
11101010101011101011111110101
10100000001000101010100000101
10111011101110101110111010111
10000010000010101000000010001
11111111111111111111111111111
