11111111111111111111111111111
10001000001010000010000000001
10101010101011101111111011111
10100010100010001010001010001
11111111111010111011101010101
10000010000010000010000000101
10101011101110111111111111101
10101010101010100010000000101
11101110101010101010111010101
10001000000010001010001010001
10111011111011101111101111111
10000010100010000010000010101
10111110101110111111111010101
10000010000010000010001000001
11111111111011101111101010111
10100000101000001000000010001
10101010101010111011101010111
10001010000010000010001010001
11111111111111111111111011111
10001010101010000010100010001
10101010101010101010101010111
10100000000000101000001000001
10111111111011101111111010111
10101000100000100010001010001
10101110111111101110101011101
10001000100000000010100010001
10111010101010111011111010111
10000010101010001010000010001
11111111111111111111111111111
