11111111111111111111111111111
10000010100010000010000000001
10101010101010111110111111101
10101010001000100000100010001
11101010111110101111101010111
10001010001000001000001010101
10111011111011111010111110101
10100010001000100010100000101
10111110101110101111101111101
10001000100000100000101000101
11101011111111111010101010101
10001010000010000010001010001
11101011111010111111111010111
10001000001010000010000010001
10101110111011111010111111101
10100010100010001000001000101
10111010101110101111111010101
10100000100010100000000010001
10111111111010111111111111101
10100010000010000010000000001
10101010111110111010111110111
10101000000010100010100000101
10101111111011101110101111101
10100000001010001000100010001
10111011111010111011111010111
10000010000010001000001000101
11111111111111101111101111101
10000000000000001000000000001
11111111111111111111111111111
