11111111111111111111111111111
10000010000010100000000000001
10101110111010111011111111111
10100010100010100000001000001
10111010101010101111111010111
10100000101000100010000010001
10111110111110111010111011101
10101010101010100010001010001
10101010101010101111101011101
10100000000010100000001010001
10111110111111111111101110111
10100000000000101000000010001
11111111111110101011101010111
10001000101000001000101010101
10101010101110101110101010101
10100010000000100000101010001
11111111111111111110111111111
10000000001000101000000010101
11101111111011101111101010101
10001010000000000000101000101
11101011101110101010101011101
10001000001000101010001000001
10111110111010111111111110101
10100000001010101010001000101
10101110111110101010101010101
10001000001000100000100010101
11101111101110101110101111101
10001000001000101000100000101
11111111111111111111111111111
