11111111111111111111111111111
10000000001000101000001010001
11101011111110101110111010111
10101000000000100000001010001
10111011111111111011111010111
10000010000000001010001000001
10111110111011111011101011101
10101000100010000010000010101
10101010111011111010111110101
10101010001010000010001000001
10101110101111101110101110101
10000000100000000000101010101
11101111111110101111101011111
10001000100000101000100000001
11101011101111111110101010101
10000000100000001000001010101
10111011111111101111101011101
10100000000000101000101000101
10101110101011101011111111101
10101000101000101000000010101
11101110111110111011111010111
10001010100010000000001000001
10111011111011101011101110111
10001010101000101010100010001
11111010101011111010111011111
10000000000010000000001000101
10111011111010111110111010101
10100000100000100000001010001
11111111111111111111111111111
