11111111111111111111111111111
10100000100000100000101010101
10101111101111101010101010101
10000010100000101010000000101
10101110101110101111101110101
10100000100010001000100010101
10111111101110101010101111101
10000000100010100010100000001
11111011101111111111111111111
10001000100010001000100000101
10101010101011101011101010101
10100010101000001000001010101
11101111111111101111111110101
10000010101000101000001000101
10111010101110101011101010101
10001010100000001000100010101
10111110111011111110101010101
10000000001000100000101010001
10111111101011101011111010101
10001010100010101000001010101
10101010101010101110111111101
10100000101000001000000000101
11111111111111111110111111111
10100000001010101000000000001
10101110111010101010111010111
10001010101010101010001010001
11101010101010101011101011101
10001000000000000010001010001
11111111111111111111111111111
