11111111111111111111111111111
10000000000000000000000000001
11111010111011111010101111111
10000010100010000010100000001
10101011101111111011101110101
10101000100000001000101000101
10111010111010111110111010101
10100010001010100000001010101
10111110111011111011101010111
10100000001010000010001010001
10101011101010111010111111111
10101000101010001010000000001
11111110101010101110111010101
10000000101010101000001010101
10101111111011111110111010101
10100000100000000010100010101
10111010111010101011111110111
10001010100010101000001000001
10111110101111101111111110111
10000010100000100010000000001
10101111101010111110111111111
10101000001010001000000000001
11101110101010111111111010101
10000010101010000010000010101
11111110111110111010101110101
10000000001000001010101000101
10101010101111111011111111101
10101010100000100010000000001
11111111111111111111111111111
