11111111111111111111111111111
10001000000010001000000000101
10111011101011101011111110101
10001010001000000010000000101
11101010111111111110101111101
10000010000000100000100010001
11111011111110101111101110111
10000010000000100000101000101
10111110111111111110101011101
10100010001010000000101010001
10111011101010101111111010111
10000010001000101000000010001
11101110111011111010111111101
10100010001000001010000000101
10101011101111101011101110101
10001000100000101010100010001
11111111111110101010111011101
10001000000000101010001010001
10101011111111101011101010111
10100010001000101000100010101
10111110101010101110111110101
10100000100010100000100000001
10111111111011101111101111111
10000000100010001000100010001
11101110101110111010111111101
10101000100010100010100000101
10101011111010111010101011101
10001000000010000010001000001
11111111111111111111111111111
