11111111111111111111111111111
10100000100000100010100000001
10111011101111101110111011111
10101000100000100010101010001
10101011101011101110101010101
10001010001000000000000010101
11101011101111111110101111101
10000000100010101010101000001
11101111101110101011111110101
10101000000000000000101000101
10101110111011111111101110111
10001000100010100010001010001
11101011101010111010111010101
10000010101010100010000000101
11101110101010101110111011101
10000000101010000000001000101
10101011111110111010101110111
10101000000000001010100010001
11101111111011101111111111111
10001010100000100000000000001
10101010111110111011101111111
10100000001000001010101000001
10101110101111101110111011111
10100010100010000010000000001
10111011111011101110111110111
10100000101010100000000010001
11111010101110101111101010101
10000010000000100000101010101
11111111111111111111111111111
