11111111111111111111111111111
10000010000000101000100010001
10101110111110101010101010111
10101000100010001010001000001
10111011101011101010101111101
10001000001000100010101000101
11101011111111111110101010101
10101000100000001000101010101
10101111101011101111101011101
10100000001010101000101000001
10111111111010101010101011111
10000000001000100010101010001
11111111101110111110111011101
10000000101010001000100010001
10111110101010101111101110111
10100000100000100000001000001
10101111111111111011111011101
10100000000000001000000010101
10111111101111111111101110101
10100000100010000000100010001
10111110111010101110111110111
10000000101000101000100000101
10111111101111101010111010101
10100010001000001010000010101
10101010111011111011111110101
10101010101000100010000010101
10101010101110101110111011101
10001000100000100000100000001
11111111111111111111111111111
